,Date,Tm,Opp,Result,MP,FG,FGA,FG%,2P,2PA,2P%,3P,3PA,3P%,FT,FTA,FT%,PTS,FG,FGA,FG%,2P,2PA,2P%,3P,3PA,3P%,FT,FTA,FT%,PTS
0,2021/3/27,LAC,PHI,W 122-112,240,45,85,0.529,34,59,0.576,11,26,0.423,21,27,0.778,122,39,77,0.506,29,51,0.569,10,26,0.385,24,33,0.727,112
1,2021/3/27,PHI,LAC,L 112-122,240,39,77,0.506,29,51,0.569,10,26,0.385,24,33,0.727,112,45,85,0.529,34,59,0.576,11,26,0.423,21,27,0.778,122
2,2021/3/27,MIL,NYK,L 96-102,240,36,87,0.414,22,51,0.431,14,36,0.389,10,16,0.625,96,40,93,0.43,24,49,0.49,16,44,0.364,6,8,0.75,102
3,2021/3/27,NYK,MIL,W 102-96,240,40,93,0.43,24,49,0.49,16,44,0.364,6,8,0.75,102,36,87,0.414,22,51,0.431,14,36,0.389,10,16,0.625,96
4,2021/3/27,HOU,MIN,W 129-107,240,50,92,0.543,32,53,0.604,18,39,0.462,11,13,0.846,129,36,85,0.424,23,45,0.511,13,40,0.325,22,28,0.786,107
5,2021/3/27,MIN,HOU,L 107-129,240,36,85,0.424,23,45,0.511,13,40,0.325,22,28,0.786,107,50,92,0.543,32,53,0.604,18,39,0.462,11,13,0.846,129
6,2021/3/27,DAL,NOP,L 103-112,240,37,83,0.446,27,52,0.519,10,31,0.323,19,24,0.792,103,42,81,0.519,33,55,0.6,9,26,0.346,19,29,0.655,112
7,2021/3/27,NOP,DAL,W 112-103,240,42,81,0.519,33,55,0.6,9,26,0.346,19,29,0.655,112,37,83,0.446,27,52,0.519,10,31,0.323,19,24,0.792,103
8,2021/3/27,BOS,OKC,W 111-94,240,44,96,0.458,32,58,0.552,12,38,0.316,11,14,0.786,111,34,83,0.41,23,45,0.511,11,38,0.289,15,24,0.625,94
9,2021/3/27,OKC,BOS,L 94-111,240,34,83,0.41,23,45,0.511,11,38,0.289,15,24,0.625,94,44,96,0.458,32,58,0.552,12,38,0.316,11,14,0.786,111
10,2021/3/27,CLE,SAC,L 98-100,240,37,84,0.44,28,58,0.483,9,26,0.346,15,23,0.652,98,41,80,0.513,34,50,0.68,7,30,0.233,11,14,0.786,100
11,2021/3/27,SAC,CLE,W 100-98,240,41,80,0.513,34,50,0.68,7,30,0.233,11,14,0.786,100,37,84,0.44,28,58,0.483,9,26,0.346,15,23,0.652,98
12,2021/3/27,CHI,SAS,L 104-120,240,41,95,0.432,33,61,0.541,8,34,0.235,14,18,0.778,104,46,85,0.541,36,60,0.6,10,25,0.4,18,28,0.643,120
13,2021/3/27,SAS,CHI,W 120-104,240,46,85,0.541,36,60,0.6,10,25,0.4,18,28,0.643,120,41,95,0.432,33,61,0.541,8,34,0.235,14,18,0.778,104
14,2021/3/27,MEM,UTA,L 110-126,240,39,97,0.402,30,64,0.469,9,33,0.273,23,30,0.767,110,46,92,0.5,27,47,0.574,19,45,0.422,15,20,0.75,126
15,2021/3/27,UTA,MEM,W 126-110,240,46,92,0.5,27,47,0.574,19,45,0.422,15,20,0.75,126,39,97,0.402,30,64,0.469,9,33,0.273,23,30,0.767,110
16,2021/3/27,DET,WAS,L 92-106,240,33,85,0.388,23,56,0.411,10,29,0.345,16,19,0.842,92,44,91,0.484,35,70,0.5,9,21,0.429,9,9,1,106
17,2021/3/27,WAS,DET,W 106-92,240,44,91,0.484,35,70,0.5,9,21,0.429,9,9,1,106,33,85,0.388,23,56,0.411,10,29,0.345,16,19,0.842,92
18,2021/3/26,CHO,MIA,W 110-105,240,39,79,0.494,21,36,0.583,18,43,0.419,14,19,0.737,110,40,87,0.46,25,44,0.568,15,43,0.349,10,20,0.5,105
19,2021/3/26,MIA,CHO,L 105-110,240,40,87,0.46,25,44,0.568,15,43,0.349,10,20,0.5,105,39,79,0.494,21,36,0.583,18,43,0.419,14,19,0.737,110
20,2021/3/26,DAL,IND,L 94-109,240,39,95,0.411,31,60,0.517,8,35,0.229,8,14,0.571,94,38,87,0.437,18,40,0.45,20,47,0.426,13,18,0.722,109
21,2021/3/26,IND,DAL,W 109-94,240,38,87,0.437,18,40,0.45,20,47,0.426,13,18,0.722,109,39,95,0.411,31,60,0.517,8,35,0.229,8,14,0.571,94
22,2021/3/26,BRK,DET,W 113-111,240,37,84,0.44,24,51,0.471,13,33,0.394,26,34,0.765,113,33,73,0.452,22,42,0.524,11,31,0.355,34,47,0.723,111
23,2021/3/26,DET,BRK,L 111-113,240,33,73,0.452,22,42,0.524,11,31,0.355,34,47,0.723,111,37,84,0.44,24,51,0.471,13,33,0.394,26,34,0.765,113
24,2021/3/26,ATL,GSW,W 124-108,240,46,84,0.548,33,51,0.647,13,33,0.394,19,24,0.792,124,39,78,0.5,27,50,0.54,12,28,0.429,18,26,0.692,108
25,2021/3/26,GSW,ATL,L 108-124,240,39,78,0.5,27,50,0.54,12,28,0.429,18,26,0.692,108,46,84,0.548,33,51,0.647,13,33,0.394,19,24,0.792,124
26,2021/3/26,CLE,LAL,L 86-100,240,31,80,0.388,26,54,0.481,5,26,0.192,19,28,0.679,86,38,78,0.487,32,52,0.615,6,26,0.231,18,25,0.72,100
27,2021/3/26,LAL,CLE,W 100-86,240,38,78,0.487,32,52,0.615,6,26,0.231,18,25,0.72,100,31,80,0.388,26,54,0.481,5,26,0.192,19,28,0.679,86
28,2021/3/26,BOS,MIL,W 122-114,240,43,88,0.489,21,41,0.512,22,47,0.468,14,16,0.875,122,44,99,0.444,25,52,0.481,19,47,0.404,7,11,0.636,114
29,2021/3/26,MIL,BOS,L 114-122,240,44,99,0.444,25,52,0.481,19,47,0.404,7,11,0.636,114,43,88,0.489,21,41,0.512,22,47,0.468,14,16,0.875,122
30,2021/3/26,HOU,MIN,L 101-107,240,37,87,0.425,20,43,0.465,17,44,0.386,10,13,0.769,101,39,103,0.379,29,65,0.446,10,38,0.263,19,24,0.792,107
31,2021/3/26,MIN,HOU,W 107-101,240,39,103,0.379,29,65,0.446,10,38,0.263,19,24,0.792,107,37,87,0.425,20,43,0.465,17,44,0.386,10,13,0.769,101
32,2021/3/26,DEN,NOP,W 113-108,240,47,93,0.505,33,65,0.508,14,28,0.5,5,7,0.714,113,39,78,0.5,27,49,0.551,12,29,0.414,18,20,0.9,108
33,2021/3/26,NOP,DEN,L 108-113,240,39,78,0.5,27,49,0.551,12,29,0.414,18,20,0.9,108,47,93,0.505,33,65,0.508,14,28,0.5,5,7,0.714,113
34,2021/3/26,ORL,POR,L 105-112,240,42,95,0.442,30,68,0.441,12,27,0.444,9,17,0.529,105,40,85,0.471,22,45,0.489,18,40,0.45,14,21,0.667,112
35,2021/3/26,POR,ORL,W 112-105,240,40,85,0.471,22,45,0.489,18,40,0.45,14,21,0.667,112,42,95,0.442,30,68,0.441,12,27,0.444,9,17,0.529,105
36,2021/3/26,PHO,TOR,W 104-100,240,43,90,0.478,34,54,0.63,9,36,0.25,9,9,1,104,37,90,0.411,25,45,0.556,12,45,0.267,14,16,0.875,100
37,2021/3/26,TOR,PHO,L 100-104,240,37,90,0.411,25,45,0.556,12,45,0.267,14,16,0.875,100,43,90,0.478,34,54,0.63,9,36,0.25,9,9,1,104
38,2021/3/26,MEM,UTA,L 114-117,240,44,97,0.454,32,67,0.478,12,30,0.4,14,18,0.778,114,45,98,0.459,33,65,0.508,12,33,0.364,15,18,0.833,117
39,2021/3/26,UTA,MEM,W 117-114,240,45,98,0.459,33,65,0.508,12,33,0.364,15,18,0.833,117,44,97,0.454,32,67,0.478,12,30,0.4,14,18,0.778,114
40,2021/3/25,LAL,PHI,L 101-109,240,34,78,0.436,25,52,0.481,9,26,0.346,24,33,0.727,101,39,80,0.488,22,35,0.629,17,45,0.378,14,21,0.667,109
41,2021/3/25,PHI,LAL,W 109-101,240,39,80,0.488,22,35,0.629,17,45,0.378,14,21,0.667,109,34,78,0.436,25,52,0.481,9,26,0.346,24,33,0.727,101
42,2021/3/25,MIA,POR,L 122-125,240,47,84,0.56,31,50,0.62,16,34,0.471,12,13,0.923,122,44,92,0.478,24,46,0.522,20,46,0.435,17,19,0.895,125
43,2021/3/25,POR,MIA,W 125-122,240,44,92,0.478,24,46,0.522,20,46,0.435,17,19,0.895,125,47,84,0.56,31,50,0.62,16,34,0.471,12,13,0.923,122
44,2021/3/25,NYK,WAS,W 106-102,240,34,93,0.366,27,65,0.415,7,28,0.25,31,42,0.738,106,37,80,0.463,29,54,0.537,8,26,0.308,20,33,0.606,102
45,2021/3/25,WAS,NYK,L 102-106,240,37,80,0.463,29,54,0.537,8,26,0.308,20,33,0.606,102,34,93,0.366,27,65,0.415,7,28,0.25,31,42,0.738,106
46,2021/3/25,GSW,SAC,L 119-141,240,45,88,0.511,28,56,0.5,17,32,0.531,12,12,1,119,53,89,0.596,34,51,0.667,19,38,0.5,16,19,0.842,141
47,2021/3/25,SAC,GSW,W 141-119,240,53,89,0.596,34,51,0.667,19,38,0.5,16,19,0.842,141,45,88,0.511,28,56,0.5,17,32,0.531,12,12,1,119
48,2021/3/25,LAC,SAS,W 98-85,240,34,89,0.382,21,55,0.382,13,34,0.382,17,18,0.944,98,33,82,0.402,25,59,0.424,8,23,0.348,11,13,0.846,85
49,2021/3/25,SAS,LAC,L 85-98,240,33,82,0.402,25,59,0.424,8,23,0.348,11,13,0.846,85,34,89,0.382,21,55,0.382,13,34,0.382,17,18,0.944,98
50,2021/3/24,CHI,CLE,L 94-103,240,37,83,0.446,29,55,0.527,8,28,0.286,12,14,0.857,94,42,92,0.457,31,63,0.492,11,29,0.379,8,10,0.8,103
51,2021/3/24,CLE,CHI,W 103-94,240,42,92,0.457,31,63,0.492,11,29,0.379,8,10,0.8,103,37,83,0.446,29,55,0.527,8,28,0.286,12,14,0.857,94
52,2021/3/24,CHO,HOU,W 122-97,240,41,80,0.513,23,42,0.548,18,38,0.474,22,29,0.759,122,33,86,0.384,17,37,0.459,16,49,0.327,15,22,0.682,97
53,2021/3/24,HOU,CHO,L 97-122,240,33,86,0.384,17,37,0.459,16,49,0.327,15,22,0.682,97,41,80,0.513,23,42,0.548,18,38,0.474,22,29,0.759,122
54,2021/3/24,DET,IND,L 111-116,240,44,83,0.53,33,55,0.6,11,28,0.393,12,19,0.632,111,45,97,0.464,30,63,0.476,15,34,0.441,11,14,0.786,116
55,2021/3/24,IND,DET,W 116-111,240,45,97,0.464,30,63,0.476,15,34,0.441,11,14,0.786,116,44,83,0.53,33,55,0.6,11,28,0.393,12,19,0.632,111
56,2021/3/24,BOS,MIL,L 119-121,240,45,94,0.479,26,47,0.553,19,47,0.404,10,10,1,119,45,90,0.5,28,53,0.528,17,37,0.459,14,20,0.7,121
57,2021/3/24,MIL,BOS,W 121-119,240,45,90,0.5,28,53,0.528,17,37,0.459,14,20,0.7,121,45,94,0.479,26,47,0.553,19,47,0.404,10,10,1,119
58,2021/3/24,DAL,MIN,W 128-108,240,48,99,0.485,32,55,0.582,16,44,0.364,16,22,0.727,128,38,86,0.442,26,48,0.542,12,38,0.316,20,26,0.769,108
59,2021/3/24,MIN,DAL,L 108-128,240,38,86,0.442,26,48,0.542,12,38,0.316,20,26,0.769,108,48,99,0.485,32,55,0.582,16,44,0.364,16,22,0.727,128
60,2021/3/24,MEM,OKC,W 116-107,240,47,99,0.475,36,69,0.522,11,30,0.367,11,13,0.846,116,43,95,0.453,33,60,0.55,10,35,0.286,11,17,0.647,107
61,2021/3/24,OKC,MEM,L 107-116,240,43,95,0.453,33,60,0.55,10,35,0.286,11,17,0.647,107,47,99,0.475,36,69,0.522,11,30,0.367,11,13,0.846,116
62,2021/3/24,ORL,PHO,W 112-111,240,42,90,0.467,29,53,0.547,13,37,0.351,15,19,0.789,112,40,90,0.444,29,57,0.509,11,33,0.333,20,22,0.909,111
63,2021/3/24,PHO,ORL,L 111-112,240,40,90,0.444,29,57,0.509,11,33,0.333,20,22,0.909,111,42,90,0.467,29,53,0.547,13,37,0.351,15,19,0.789,112
64,2021/3/24,ATL,SAC,L 108-110,240,41,85,0.482,34,60,0.567,7,25,0.28,19,23,0.826,108,40,84,0.476,30,54,0.556,10,30,0.333,20,22,0.909,110
65,2021/3/24,SAC,ATL,W 110-108,240,40,84,0.476,30,54,0.556,10,30,0.333,20,22,0.909,110,41,85,0.482,34,60,0.567,7,25,0.28,19,23,0.826,108
66,2021/3/24,LAC,SAS,W 134-101,240,49,88,0.557,32,55,0.582,17,33,0.515,19,30,0.633,134,39,85,0.459,32,63,0.508,7,22,0.318,16,19,0.842,101
67,2021/3/24,SAS,LAC,L 101-134,240,39,85,0.459,32,63,0.508,7,22,0.318,16,19,0.842,101,49,88,0.557,32,55,0.582,17,33,0.515,19,30,0.633,134
68,2021/3/24,DEN,TOR,L 111-135,240,41,98,0.418,27,55,0.491,14,43,0.326,15,18,0.833,111,45,89,0.506,21,41,0.512,24,48,0.5,21,23,0.913,135
69,2021/3/24,TOR,DEN,W 135-111,240,45,89,0.506,21,41,0.512,24,48,0.5,21,23,0.913,135,41,98,0.418,27,55,0.491,14,43,0.326,15,18,0.833,111
70,2021/3/24,BRK,UTA,L 88-118,240,35,97,0.361,28,62,0.452,7,35,0.2,11,15,0.733,88,41,91,0.451,18,36,0.5,23,55,0.418,13,14,0.929,118
71,2021/3/24,UTA,BRK,W 118-88,240,41,91,0.451,18,36,0.5,23,55,0.418,13,14,0.929,118,35,97,0.361,28,62,0.452,7,35,0.2,11,15,0.733,88
72,2021/3/23,GSW,PHI,L 98-108,240,36,83,0.434,28,58,0.483,8,25,0.32,18,26,0.692,98,39,86,0.453,32,62,0.516,7,24,0.292,23,35,0.657,108
73,2021/3/23,PHI,GSW,W 108-98,240,39,86,0.453,32,62,0.516,7,24,0.292,23,35,0.657,108,36,83,0.434,28,58,0.483,8,25,0.32,18,26,0.692,98
74,2021/3/23,MIA,PHO,L 100-110,240,36,86,0.419,23,50,0.46,13,36,0.361,15,17,0.882,100,45,91,0.495,33,54,0.611,12,37,0.324,8,9,0.889,110
75,2021/3/23,PHO,MIA,W 110-100,240,45,91,0.495,33,54,0.611,12,37,0.324,8,9,0.889,110,36,86,0.419,23,50,0.46,13,36,0.361,15,17,0.882,100
76,2021/3/23,LAL,NOP,L 111-128,240,36,85,0.424,18,48,0.375,18,37,0.486,21,30,0.7,111,47,90,0.522,37,61,0.607,10,29,0.345,24,26,0.923,128
77,2021/3/23,NOP,LAL,W 128-111,240,47,90,0.522,37,61,0.607,10,29,0.345,24,26,0.923,128,36,85,0.424,18,48,0.375,18,37,0.486,21,30,0.7,111
78,2021/3/23,NYK,WAS,W 131-113,240,47,92,0.511,31,62,0.5,16,30,0.533,21,24,0.875,131,38,79,0.481,29,56,0.518,9,23,0.391,28,35,0.8,113
79,2021/3/23,WAS,NYK,L 113-131,240,38,79,0.481,29,56,0.518,9,23,0.391,28,35,0.8,113,47,92,0.511,31,62,0.5,16,30,0.533,21,24,0.875,131
80,2021/3/23,DEN,ORL,W 110-99,240,45,91,0.495,37,61,0.607,8,30,0.267,12,13,0.923,110,39,88,0.443,28,54,0.519,11,34,0.324,10,14,0.714,99
81,2021/3/23,ORL,DEN,L 99-110,240,39,88,0.443,28,54,0.519,11,34,0.324,10,14,0.714,99,45,91,0.495,37,61,0.607,8,30,0.267,12,13,0.923,110
82,2021/3/23,BRK,POR,W 116-112,240,43,87,0.494,34,57,0.596,9,30,0.3,21,27,0.778,116,36,90,0.4,17,35,0.486,19,55,0.345,21,23,0.913,112
83,2021/3/23,POR,BRK,L 112-116,240,36,90,0.4,17,35,0.486,19,55,0.345,21,23,0.913,112,43,87,0.494,34,57,0.596,9,30,0.3,21,27,0.778,116
84,2021/3/22,CHI,UTA,L 95-120,240,39,96,0.406,33,70,0.471,6,26,0.231,11,12,0.917,95,45,92,0.489,28,53,0.528,17,39,0.436,13,15,0.867,120
85,2021/3/22,UTA,CHI,W 120-95,240,45,92,0.489,28,53,0.528,17,39,0.436,13,15,0.867,120,39,96,0.406,33,70,0.471,6,26,0.231,11,12,0.917,95
86,2021/3/22,CLE,SAC,L 105-119,240,41,96,0.427,37,79,0.468,4,17,0.235,19,23,0.826,105,49,90,0.544,36,60,0.6,13,30,0.433,8,12,0.667,119
87,2021/3/22,SAC,CLE,W 119-105,240,49,90,0.544,36,60,0.6,13,30,0.433,8,12,0.667,119,41,96,0.427,37,79,0.468,4,17,0.235,19,23,0.826,105
88,2021/3/22,HOU,TOR,W 117-99,240,41,90,0.456,27,54,0.5,14,36,0.389,21,26,0.808,117,37,87,0.425,27,47,0.574,10,40,0.25,15,19,0.789,99
89,2021/3/22,TOR,HOU,L 99-117,240,37,87,0.425,27,47,0.574,10,40,0.25,15,19,0.789,99,41,90,0.456,27,54,0.5,14,36,0.389,21,26,0.808,117
90,2021/3/22,ATL,LAC,L 110-119,240,43,95,0.453,31,61,0.508,12,34,0.353,12,16,0.75,110,42,85,0.494,25,47,0.532,17,38,0.447,18,20,0.9,119
91,2021/3/22,LAC,ATL,W 119-110,240,42,85,0.494,25,47,0.532,17,38,0.447,18,20,0.9,119,43,95,0.453,31,61,0.508,12,34,0.353,12,16,0.75,110
92,2021/3/22,BOS,MEM,L 126-132 (OT),265,47,90,0.522,30,55,0.545,17,35,0.486,15,24,0.625,126,55,110,0.5,43,75,0.573,12,35,0.343,10,15,0.667,132
93,2021/3/22,MEM,BOS,W 132-126 (OT),265,55,110,0.5,43,75,0.573,12,35,0.343,10,15,0.667,132,47,90,0.522,30,55,0.545,17,35,0.486,15,24,0.625,126
94,2021/3/22,IND,MIL,L 113-140,240,45,111,0.405,33,61,0.541,12,50,0.24,11,12,0.917,113,53,94,0.564,29,55,0.527,24,39,0.615,10,15,0.667,140
95,2021/3/22,MIL,IND,W 140-113,240,53,94,0.564,29,55,0.527,24,39,0.615,10,15,0.667,140,45,111,0.405,33,61,0.541,12,50,0.24,11,12,0.917,113
96,2021/3/22,MIN,OKC,L 103-112,240,38,92,0.413,24,53,0.453,14,39,0.359,13,18,0.722,103,41,87,0.471,20,50,0.4,21,37,0.568,9,10,0.9,112
97,2021/3/22,OKC,MIN,W 112-103,240,41,87,0.471,20,50,0.4,21,37,0.568,9,10,0.9,112,38,92,0.413,24,53,0.453,14,39,0.359,13,18,0.722,103
98,2021/3/22,CHO,SAS,W 100-97,240,34,81,0.42,22,49,0.449,12,32,0.375,20,23,0.87,100,36,78,0.462,25,46,0.543,11,32,0.344,14,17,0.824,97
99,2021/3/22,SAS,CHO,L 97-100,240,36,78,0.462,25,46,0.543,11,32,0.344,14,17,0.824,97,34,81,0.42,22,49,0.449,12,32,0.375,20,23,0.87,100
100,2021/3/21,BOS,ORL,W 112-96,240,40,88,0.455,17,33,0.515,23,55,0.418,9,9,1,112,32,84,0.381,21,50,0.42,11,34,0.324,21,30,0.7,96
101,2021/3/21,ORL,BOS,L 96-112,240,32,84,0.381,21,50,0.42,11,34,0.324,21,30,0.7,96,40,88,0.455,17,33,0.515,23,55,0.418,9,9,1,112
102,2021/3/21,BRK,WAS,W 113-106,240,44,90,0.489,35,61,0.574,9,29,0.31,16,22,0.727,113,42,79,0.532,35,58,0.603,7,21,0.333,15,19,0.789,106
103,2021/3/21,WAS,BRK,L 106-113,240,42,79,0.532,35,58,0.603,7,21,0.333,15,19,0.789,106,44,90,0.489,35,61,0.574,9,29,0.31,16,22,0.727,113
104,2021/3/21,CLE,TOR,W 116-105,240,39,77,0.506,22,44,0.5,17,33,0.515,21,28,0.75,116,37,95,0.389,22,49,0.449,15,46,0.326,16,19,0.842,105
105,2021/3/21,TOR,CLE,L 105-116,240,37,95,0.389,22,49,0.449,15,46,0.326,16,19,0.842,105,39,77,0.506,22,44,0.5,17,33,0.515,21,28,0.75,116
106,2021/3/21,DEN,NOP,L 108-113,240,44,88,0.5,32,54,0.593,12,34,0.353,8,10,0.8,108,41,85,0.482,33,57,0.579,8,28,0.286,23,30,0.767,113
107,2021/3/21,NOP,DEN,W 113-108,240,41,85,0.482,33,57,0.579,8,28,0.286,23,30,0.767,113,44,88,0.5,32,54,0.593,12,34,0.353,8,10,0.8,108
108,2021/3/21,CHI,DET,W 100-86,240,37,80,0.463,23,52,0.442,14,28,0.5,12,14,0.857,100,32,82,0.39,28,57,0.491,4,25,0.16,18,25,0.72,86
109,2021/3/21,DET,CHI,L 86-100,240,32,82,0.39,28,57,0.491,4,25,0.16,18,25,0.72,86,37,80,0.463,23,52,0.442,14,28,0.5,12,14,0.857,100
110,2021/3/21,HOU,OKC,L 112-114,240,39,79,0.494,25,41,0.61,14,38,0.368,20,27,0.741,112,42,91,0.462,29,52,0.558,13,39,0.333,17,25,0.68,114
111,2021/3/21,OKC,HOU,W 114-112,240,42,91,0.462,29,52,0.558,13,39,0.333,17,25,0.68,114,39,79,0.494,25,41,0.61,14,38,0.368,20,27,0.741,112
112,2021/3/21,IND,MIA,W 109-106 (OT),265,38,98,0.388,23,53,0.434,15,45,0.333,18,20,0.9,109,39,97,0.402,30,60,0.5,9,37,0.243,19,23,0.826,106
113,2021/3/21,MIA,IND,L 106-109 (OT),265,39,97,0.402,30,60,0.5,9,37,0.243,19,23,0.826,106,38,98,0.388,23,53,0.434,15,45,0.333,18,20,0.9,109
114,2021/3/21,NYK,PHI,L 100-101 (OT),265,38,88,0.432,27,64,0.422,11,24,0.458,13,23,0.565,100,38,82,0.463,27,57,0.474,11,25,0.44,14,23,0.609,101
115,2021/3/21,PHI,NYK,W 101-100 (OT),265,38,82,0.463,27,57,0.474,11,25,0.44,14,23,0.609,101,38,88,0.432,27,64,0.422,11,24,0.458,13,23,0.565,100
116,2021/3/21,LAL,PHO,L 94-111,240,35,85,0.412,30,60,0.5,5,25,0.2,19,28,0.679,94,42,87,0.483,33,55,0.6,9,32,0.281,18,23,0.783,111
117,2021/3/21,PHO,LAL,W 111-94,240,42,87,0.483,33,55,0.6,9,32,0.281,18,23,0.783,111,35,85,0.412,30,60,0.5,5,25,0.2,19,28,0.679,94
118,2021/3/21,DAL,POR,W 132-92,240,48,86,0.558,29,49,0.592,19,37,0.514,17,20,0.85,132,34,89,0.382,25,48,0.521,9,41,0.22,15,19,0.789,92
119,2021/3/21,POR,DAL,L 92-132,240,34,89,0.382,25,48,0.521,9,41,0.22,15,19,0.789,92,48,86,0.558,29,49,0.592,19,37,0.514,17,20,0.85,132
120,2021/3/20,CHO,LAC,L 98-125,240,31,80,0.388,16,39,0.41,15,41,0.366,21,28,0.75,98,45,86,0.523,33,52,0.635,12,34,0.353,23,23,1,125
121,2021/3/20,LAC,CHO,W 125-98,240,45,86,0.523,33,52,0.635,12,34,0.353,23,23,1,125,31,80,0.388,16,39,0.41,15,41,0.366,21,28,0.75,98
122,2021/3/20,ATL,LAL,W 99-94,240,39,98,0.398,26,61,0.426,13,37,0.351,8,9,0.889,99,34,81,0.42,26,55,0.473,8,26,0.308,18,24,0.75,94
123,2021/3/20,LAL,ATL,L 94-99,240,34,81,0.42,26,55,0.473,8,26,0.308,18,24,0.75,94,39,98,0.398,26,61,0.426,13,37,0.351,8,9,0.889,99
124,2021/3/20,GSW,MEM,L 103-111,240,31,90,0.344,18,49,0.367,13,41,0.317,28,34,0.824,103,37,95,0.389,27,63,0.429,10,32,0.313,27,31,0.871,111
125,2021/3/20,MEM,GSW,W 111-103,240,37,95,0.389,27,63,0.429,10,32,0.313,27,31,0.871,111,31,90,0.344,18,49,0.367,13,41,0.317,28,34,0.824,103
126,2021/3/20,MIL,SAS,W 120-113,240,45,92,0.489,31,54,0.574,14,38,0.368,16,18,0.889,120,46,96,0.479,34,63,0.54,12,33,0.364,9,10,0.9,113
127,2021/3/20,SAS,MIL,L 113-120,240,46,96,0.479,34,63,0.54,12,33,0.364,9,10,0.9,113,45,92,0.489,31,54,0.574,14,38,0.368,16,18,0.889,120
128,2021/3/20,PHI,SAC,W 129-105,240,48,86,0.558,37,63,0.587,11,23,0.478,22,29,0.759,129,39,85,0.459,29,57,0.509,10,28,0.357,17,27,0.63,105
129,2021/3/20,SAC,PHI,L 105-129,240,39,85,0.459,29,57,0.509,10,28,0.357,17,27,0.63,105,48,86,0.558,37,63,0.587,11,23,0.478,22,29,0.759,129
130,2021/3/19,BOS,SAC,L 96-107,240,39,91,0.429,27,60,0.45,12,31,0.387,6,7,0.857,96,37,81,0.457,25,51,0.49,12,30,0.4,21,26,0.808,107
131,2021/3/19,SAC,BOS,W 107-96,240,37,81,0.457,25,51,0.49,12,30,0.4,21,26,0.808,107,39,91,0.429,27,60,0.45,12,31,0.387,6,7,0.857,96
132,2021/3/19,CLE,SAS,L 110-116,240,39,89,0.438,32,62,0.516,7,27,0.259,25,32,0.781,110,41,88,0.466,34,70,0.486,7,18,0.389,27,33,0.818,116
133,2021/3/19,SAS,CLE,W 116-110,240,41,88,0.466,34,70,0.486,7,18,0.389,27,33,0.818,116,39,89,0.438,32,62,0.516,7,27,0.259,25,32,0.781,110
134,2021/3/19,CHI,DEN,L 127-131 (OT),265,47,90,0.522,30,55,0.545,17,35,0.486,16,23,0.696,127,48,91,0.527,34,57,0.596,14,34,0.412,21,27,0.778,131
135,2021/3/19,DEN,CHI,W 131-127 (OT),265,48,91,0.527,34,57,0.596,14,34,0.412,21,27,0.778,131,47,90,0.522,30,55,0.545,17,35,0.486,16,23,0.696,127
136,2021/3/19,DET,HOU,W 113-100,240,37,85,0.435,23,56,0.411,14,29,0.483,25,28,0.893,113,39,88,0.443,30,56,0.536,9,32,0.281,13,16,0.813,100
137,2021/3/19,HOU,DET,L 100-113,240,39,88,0.443,30,56,0.536,9,32,0.281,13,16,0.813,100,37,85,0.435,23,56,0.411,14,29,0.483,25,28,0.893,113
138,2021/3/19,GSW,MEM,W 116-103,240,44,91,0.484,29,50,0.58,15,41,0.366,13,18,0.722,116,39,84,0.464,31,58,0.534,8,26,0.308,17,21,0.81,103
139,2021/3/19,MEM,GSW,L 103-116,240,39,84,0.464,31,58,0.534,8,26,0.308,17,21,0.81,103,44,91,0.484,29,50,0.58,15,41,0.366,13,18,0.722,116
140,2021/3/19,IND,MIA,W 137-110,240,52,89,0.584,32,53,0.604,20,36,0.556,13,19,0.684,137,41,92,0.446,32,58,0.552,9,34,0.265,19,20,0.95,110
141,2021/3/19,MIA,IND,L 110-137,240,41,92,0.446,32,58,0.552,9,34,0.265,19,20,0.95,110,52,89,0.584,32,53,0.604,20,36,0.556,13,19,0.684,137
142,2021/3/19,BRK,ORL,L 113-121,240,43,91,0.473,33,54,0.611,10,37,0.27,17,23,0.739,113,43,84,0.512,22,44,0.5,21,40,0.525,14,20,0.7,121
143,2021/3/19,ORL,BRK,W 121-113,240,43,84,0.512,22,44,0.5,21,40,0.525,14,20,0.7,121,43,91,0.473,33,54,0.611,10,37,0.27,17,23,0.739,113
144,2021/3/19,MIN,PHO,L 101-113,240,37,79,0.468,24,44,0.545,13,35,0.371,14,18,0.778,101,43,86,0.5,29,59,0.492,14,27,0.519,13,17,0.765,113
145,2021/3/19,PHO,MIN,W 113-101,240,43,86,0.5,29,59,0.492,14,27,0.519,13,17,0.765,113,37,79,0.468,24,44,0.545,13,35,0.371,14,18,0.778,101
146,2021/3/19,DAL,POR,L 119-125,240,44,81,0.543,25,39,0.641,19,42,0.452,12,13,0.923,119,44,93,0.473,22,46,0.478,22,47,0.468,15,17,0.882,125
147,2021/3/19,POR,DAL,W 125-119,240,44,93,0.473,22,46,0.478,22,47,0.468,15,17,0.882,125,44,81,0.543,25,39,0.641,19,42,0.452,12,13,0.923,119
148,2021/3/19,TOR,UTA,L 112-115,240,40,83,0.482,19,39,0.487,21,44,0.477,11,14,0.786,112,34,74,0.459,22,37,0.595,12,37,0.324,35,41,0.854,115
149,2021/3/19,UTA,TOR,W 115-112,240,34,74,0.459,22,37,0.595,12,37,0.324,35,41,0.854,115,40,83,0.482,19,39,0.487,21,44,0.477,11,14,0.786,112
150,2021/3/18,ATL,OKC,W 116-93,240,47,87,0.54,36,54,0.667,11,33,0.333,11,13,0.846,116,34,93,0.366,21,59,0.356,13,34,0.382,12,16,0.75,93
151,2021/3/18,OKC,ATL,L 93-116,240,34,93,0.366,21,59,0.356,13,34,0.382,12,16,0.75,93,47,87,0.54,36,54,0.667,11,33,0.333,11,13,0.846,116
152,2021/3/18,CHO,LAL,L 105-116,240,41,83,0.494,30,54,0.556,11,29,0.379,12,20,0.6,105,44,92,0.478,31,53,0.585,13,39,0.333,15,20,0.75,116
153,2021/3/18,LAL,CHO,W 116-105,240,44,92,0.478,31,53,0.585,13,39,0.333,15,20,0.75,116,41,83,0.494,30,54,0.556,11,29,0.379,12,20,0.6,105
154,2021/3/18,NYK,ORL,W 94-93,240,37,86,0.43,23,52,0.442,14,34,0.412,6,11,0.545,94,35,82,0.427,25,48,0.521,10,34,0.294,13,16,0.813,93
155,2021/3/18,ORL,NYK,L 93-94,240,35,82,0.427,25,48,0.521,10,34,0.294,13,16,0.813,93,37,86,0.43,23,52,0.442,14,34,0.412,6,11,0.545,94
156,2021/3/18,MIN,PHO,W 123-119,240,44,93,0.473,33,59,0.559,11,34,0.324,24,35,0.686,123,45,85,0.529,30,49,0.612,15,36,0.417,14,19,0.737,119
157,2021/3/18,PHO,MIN,L 119-123,240,45,85,0.529,30,49,0.612,15,36,0.417,14,19,0.737,119,44,93,0.473,33,59,0.559,11,34,0.324,24,35,0.686,123
158,2021/3/18,NOP,POR,L 93-101,240,33,83,0.398,23,46,0.5,10,37,0.27,17,25,0.68,93,33,87,0.379,19,44,0.432,14,43,0.326,21,25,0.84,101
159,2021/3/18,POR,NOP,W 101-93,240,33,87,0.379,19,44,0.432,14,43,0.326,21,25,0.84,101,33,83,0.398,23,46,0.5,10,37,0.27,17,25,0.68,93
160,2021/3/18,UTA,WAS,L 122-131,240,44,96,0.458,26,48,0.542,18,48,0.375,16,28,0.571,122,47,86,0.547,40,69,0.58,7,17,0.412,30,38,0.789,131
161,2021/3/18,WAS,UTA,W 131-122,240,47,86,0.547,40,69,0.58,7,17,0.412,30,38,0.789,131,44,96,0.458,26,48,0.542,18,48,0.375,16,28,0.571,122
162,2021/3/17,CHI,SAS,L 99-106,240,40,91,0.44,29,58,0.5,11,33,0.333,8,9,0.889,99,38,89,0.427,30,58,0.517,8,31,0.258,22,30,0.733,106
163,2021/3/17,SAS,CHI,W 106-99,240,38,89,0.427,30,58,0.517,8,31,0.258,22,30,0.733,106,40,91,0.44,29,58,0.5,11,33,0.333,8,9,0.889,99
164,2021/3/17,BOS,CLE,L 110-117,240,40,88,0.455,30,50,0.6,10,38,0.263,20,29,0.69,110,40,74,0.541,30,51,0.588,10,23,0.435,27,33,0.818,117
165,2021/3/17,CLE,BOS,W 117-110,240,40,74,0.541,30,51,0.588,10,23,0.435,27,33,0.818,117,40,88,0.455,30,50,0.6,10,38,0.263,20,29,0.69,110
166,2021/3/17,DAL,LAC,W 105-89,240,40,79,0.506,25,45,0.556,15,34,0.441,10,12,0.833,105,37,88,0.42,28,56,0.5,9,32,0.281,6,11,0.545,89
167,2021/3/17,LAC,DAL,L 89-105,240,37,88,0.42,28,56,0.5,9,32,0.281,6,11,0.545,89,40,79,0.506,25,45,0.556,15,34,0.441,10,12,0.833,105
168,2021/3/17,CHO,DEN,L 104-129,240,36,80,0.45,24,42,0.571,12,38,0.316,20,28,0.714,104,52,90,0.578,36,46,0.783,16,44,0.364,9,13,0.692,129
169,2021/3/17,DEN,CHO,W 129-104,240,52,90,0.578,36,46,0.783,16,44,0.364,9,13,0.692,129,36,80,0.45,24,42,0.571,12,38,0.316,20,28,0.714,104
170,2021/3/17,DET,TOR,W 116-112,240,38,75,0.507,26,46,0.565,12,29,0.414,28,32,0.875,116,37,86,0.43,25,46,0.543,12,40,0.3,26,34,0.765,112
171,2021/3/17,TOR,DET,L 112-116,240,37,86,0.43,25,46,0.543,12,40,0.3,26,34,0.765,112,38,75,0.507,26,46,0.565,12,29,0.414,28,32,0.875,116
172,2021/3/17,GSW,HOU,W 108-94,240,41,90,0.456,25,45,0.556,16,45,0.356,10,12,0.833,108,33,80,0.413,26,53,0.491,7,27,0.259,21,40,0.525,94
173,2021/3/17,HOU,GSW,L 94-108,240,33,80,0.413,26,53,0.491,7,27,0.259,21,40,0.525,94,41,90,0.456,25,45,0.556,16,45,0.356,10,12,0.833,108
174,2021/3/17,BRK,IND,W 124-115,240,42,87,0.483,33,60,0.55,9,27,0.333,31,40,0.775,124,43,84,0.512,34,52,0.654,9,32,0.281,20,25,0.8,115
175,2021/3/17,IND,BRK,L 115-124,240,43,84,0.512,34,52,0.654,9,32,0.281,20,25,0.8,115,42,87,0.483,33,60,0.55,9,27,0.333,31,40,0.775,124
176,2021/3/17,MEM,MIA,W 89-85,240,30,85,0.353,20,43,0.465,10,42,0.238,19,25,0.76,89,32,89,0.36,24,55,0.436,8,34,0.235,13,18,0.722,85
177,2021/3/17,MIA,MEM,L 85-89,240,32,89,0.36,24,55,0.436,8,34,0.235,13,18,0.722,85,30,85,0.353,20,43,0.465,10,42,0.238,19,25,0.76,89
178,2021/3/17,MIL,PHI,W 109-105 (OT),265,41,101,0.406,32,62,0.516,9,39,0.231,18,24,0.75,109,43,109,0.394,29,68,0.426,14,41,0.341,5,8,0.625,105
179,2021/3/17,PHI,MIL,L 105-109 (OT),265,43,109,0.394,29,68,0.426,14,41,0.341,5,8,0.625,105,41,101,0.406,32,62,0.516,9,39,0.231,18,24,0.75,109
180,2021/3/17,SAC,WAS,W 121-119,240,41,93,0.441,31,60,0.517,10,33,0.303,29,35,0.829,121,46,94,0.489,42,69,0.609,4,25,0.16,23,28,0.821,119
181,2021/3/17,WAS,SAC,L 119-121,240,46,94,0.489,42,69,0.609,4,25,0.16,23,28,0.821,119,41,93,0.441,31,60,0.517,10,33,0.303,29,35,0.829,121
182,2021/3/16,BOS,UTA,L 109-117,240,48,98,0.49,38,69,0.551,10,29,0.345,3,4,0.75,109,38,80,0.475,19,37,0.514,19,43,0.442,22,24,0.917,117
183,2021/3/16,UTA,BOS,W 117-109,240,38,80,0.475,19,37,0.514,19,43,0.442,22,24,0.917,117,48,98,0.49,38,69,0.551,10,29,0.345,3,4,0.75,109
184,2021/3/16,CHI,OKC,W 123-102,240,48,94,0.511,36,58,0.621,12,36,0.333,15,18,0.833,123,42,90,0.467,35,70,0.5,7,20,0.35,11,13,0.846,102
185,2021/3/16,OKC,CHI,L 102-123,240,42,90,0.467,35,70,0.5,7,20,0.35,11,13,0.846,102,48,94,0.511,36,58,0.621,12,36,0.333,15,18,0.833,123
186,2021/3/16,ATL,HOU,W 119-107,240,44,86,0.512,27,49,0.551,17,37,0.459,14,16,0.875,119,42,88,0.477,29,54,0.537,13,34,0.382,10,13,0.769,107
187,2021/3/16,HOU,ATL,L 107-119,240,42,88,0.477,29,54,0.537,13,34,0.382,10,13,0.769,107,44,86,0.512,27,49,0.551,17,37,0.459,14,16,0.875,119
188,2021/3/16,LAL,MIN,W 137-121,240,50,87,0.575,37,61,0.607,13,26,0.5,24,28,0.857,137,47,90,0.522,36,55,0.655,11,35,0.314,16,22,0.727,121
189,2021/3/16,MIN,LAL,L 121-137,240,47,90,0.522,36,55,0.655,11,35,0.314,16,22,0.727,121,50,87,0.575,37,61,0.607,13,26,0.5,24,28,0.857,137
190,2021/3/16,CLE,MIA,L 98-113,240,39,86,0.453,29,51,0.569,10,35,0.286,10,14,0.714,98,42,85,0.494,32,58,0.552,10,27,0.37,19,21,0.905,113
191,2021/3/16,MIA,CLE,W 113-98,240,42,85,0.494,32,58,0.552,10,27,0.37,19,21,0.905,113,39,86,0.453,29,51,0.569,10,35,0.286,10,14,0.714,98
192,2021/3/16,NYK,PHI,L 96-99,240,37,84,0.44,29,60,0.483,8,24,0.333,14,22,0.636,96,37,90,0.411,26,58,0.448,11,32,0.344,14,19,0.737,99
193,2021/3/16,PHI,NYK,W 99-96,240,37,90,0.411,26,58,0.448,11,32,0.344,14,19,0.737,99,37,84,0.44,29,60,0.483,8,24,0.333,14,22,0.636,96
194,2021/3/16,NOP,POR,L 124-125,240,46,88,0.523,30,55,0.545,16,33,0.485,16,20,0.8,124,38,73,0.521,20,30,0.667,18,43,0.419,31,31,1,125
195,2021/3/16,POR,NOP,W 125-124,240,38,73,0.521,20,30,0.667,18,43,0.419,31,31,1,125,46,88,0.523,30,55,0.545,16,33,0.485,16,20,0.8,124
196,2021/3/15,BRK,NYK,W 117-112,240,44,76,0.579,32,47,0.681,12,29,0.414,17,22,0.773,117,37,92,0.402,22,50,0.44,15,42,0.357,23,27,0.852,112
197,2021/3/15,NYK,BRK,L 112-117,240,37,92,0.402,22,50,0.44,15,42,0.357,23,27,0.852,112,44,76,0.579,32,47,0.681,12,29,0.414,17,22,0.773,117
198,2021/3/15,CHO,SAC,W 122-116,240,45,94,0.479,33,64,0.516,12,30,0.4,20,25,0.8,122,48,86,0.558,39,55,0.709,9,31,0.29,11,17,0.647,116
199,2021/3/15,SAC,CHO,L 116-122,240,48,86,0.558,39,55,0.709,9,31,0.29,11,17,0.647,116,45,94,0.479,33,64,0.516,12,30,0.4,20,25,0.8,122
200,2021/3/15,DAL,LAC,L 99-109,240,39,79,0.494,22,38,0.579,17,41,0.415,4,5,0.8,99,43,86,0.5,29,54,0.537,14,32,0.438,9,11,0.818,109
201,2021/3/15,LAC,DAL,W 109-99,240,43,86,0.5,29,54,0.537,14,32,0.438,9,11,0.818,109,39,79,0.494,22,38,0.579,17,41,0.415,4,5,0.8,99
202,2021/3/15,DEN,IND,W 121-106,240,45,97,0.464,30,69,0.435,15,28,0.536,16,19,0.842,121,39,90,0.433,22,48,0.458,17,42,0.405,11,13,0.846,106
203,2021/3/15,IND,DEN,L 106-121,240,39,90,0.433,22,48,0.458,17,42,0.405,11,13,0.846,106,45,97,0.464,30,69,0.435,15,28,0.536,16,19,0.842,121
204,2021/3/15,DET,SAS,L 99-109,240,39,83,0.47,32,58,0.552,7,25,0.28,14,25,0.56,99,47,83,0.566,35,58,0.603,12,25,0.48,3,5,0.6,109
205,2021/3/15,SAS,DET,W 109-99,240,47,83,0.566,35,58,0.603,12,25,0.48,3,5,0.6,109,39,83,0.47,32,58,0.552,7,25,0.28,14,25,0.56,99
206,2021/3/15,GSW,LAL,L 97-128,240,34,79,0.43,21,42,0.5,13,37,0.351,16,24,0.667,97,49,78,0.628,38,51,0.745,11,27,0.407,19,25,0.76,128
207,2021/3/15,LAL,GSW,W 128-97,240,49,78,0.628,38,51,0.745,11,27,0.407,19,25,0.76,128,34,79,0.43,21,42,0.5,13,37,0.351,16,24,0.667,97
208,2021/3/15,MEM,PHO,L 99-122,240,38,87,0.437,33,64,0.516,5,23,0.217,18,26,0.692,99,47,83,0.566,35,53,0.66,12,30,0.4,16,18,0.889,122
209,2021/3/15,PHO,MEM,W 122-99,240,47,83,0.566,35,53,0.66,12,30,0.4,16,18,0.889,122,38,87,0.437,33,64,0.516,5,23,0.217,18,26,0.692,99
210,2021/3/15,MIL,WAS,W 133-122,240,52,94,0.553,41,66,0.621,11,28,0.393,18,19,0.947,133,44,87,0.506,28,49,0.571,16,38,0.421,18,24,0.75,122
211,2021/3/15,WAS,MIL,L 122-133,240,44,87,0.506,28,49,0.571,16,38,0.421,18,24,0.75,122,52,94,0.553,41,66,0.621,11,28,0.393,18,19,0.947,133
212,2021/3/14,ATL,CLE,W 100-82,240,32,71,0.451,20,42,0.476,12,29,0.414,24,26,0.923,100,31,81,0.383,23,51,0.451,8,30,0.267,12,23,0.522,82
213,2021/3/14,CLE,ATL,L 82-100,240,31,81,0.383,23,51,0.451,8,30,0.267,12,23,0.522,82,32,71,0.451,20,42,0.476,12,29,0.414,24,26,0.923,100
214,2021/3/14,CHI,TOR,W 118-95,240,44,97,0.454,32,53,0.604,12,44,0.273,18,23,0.783,118,34,90,0.378,22,45,0.489,12,45,0.267,15,21,0.714,95
215,2021/3/14,TOR,CHI,L 95-118,240,34,90,0.378,22,45,0.489,12,45,0.267,15,21,0.714,95,44,97,0.454,32,53,0.604,12,44,0.273,18,23,0.783,118
216,2021/3/14,GSW,UTA,W 131-119,240,50,89,0.562,34,58,0.586,16,31,0.516,15,18,0.833,131,41,93,0.441,26,49,0.531,15,44,0.341,22,29,0.759,119
217,2021/3/14,UTA,GSW,L 119-131,240,41,93,0.441,26,49,0.531,15,44,0.341,22,29,0.759,119,50,89,0.562,34,58,0.586,16,31,0.516,15,18,0.833,131
218,2021/3/14,BOS,HOU,W 134-107,240,51,92,0.554,33,55,0.6,18,37,0.486,14,21,0.667,134,35,91,0.385,19,41,0.463,16,50,0.32,21,31,0.677,107
219,2021/3/14,HOU,BOS,L 107-134,240,35,91,0.385,19,41,0.463,16,50,0.32,21,31,0.677,107,51,92,0.554,33,55,0.6,18,37,0.486,14,21,0.667,134
220,2021/3/14,MIN,POR,W 114-112,240,36,73,0.493,23,35,0.657,13,38,0.342,29,39,0.744,114,39,89,0.438,22,44,0.5,17,45,0.378,17,21,0.81,112
221,2021/3/14,POR,MIN,L 112-114,240,39,89,0.438,22,44,0.5,17,45,0.378,17,21,0.81,112,36,73,0.493,23,35,0.657,13,38,0.342,29,39,0.744,114
222,2021/3/14,LAC,NOP,L 115-135,240,42,92,0.457,27,49,0.551,15,43,0.349,16,19,0.842,115,53,81,0.654,41,55,0.745,12,26,0.462,17,21,0.81,135
223,2021/3/14,NOP,LAC,W 135-115,240,53,81,0.654,41,55,0.745,12,26,0.462,17,21,0.81,135,42,92,0.457,27,49,0.551,15,43,0.349,16,19,0.842,115
224,2021/3/14,MEM,OKC,L 122-128,240,47,92,0.511,40,70,0.571,7,22,0.318,21,29,0.724,122,42,73,0.575,26,42,0.619,16,31,0.516,28,34,0.824,128
225,2021/3/14,OKC,MEM,W 128-122,240,42,73,0.575,26,42,0.619,16,31,0.516,28,34,0.824,128,47,92,0.511,40,70,0.571,7,22,0.318,21,29,0.724,122
226,2021/3/14,MIA,ORL,W 102-97,240,37,89,0.416,23,39,0.59,14,50,0.28,14,15,0.933,102,33,75,0.44,17,35,0.486,16,40,0.4,15,21,0.714,97
227,2021/3/14,ORL,MIA,L 97-102,240,33,75,0.44,17,35,0.486,16,40,0.4,15,21,0.714,97,37,89,0.416,23,39,0.59,14,50,0.28,14,15,0.933,102
228,2021/3/14,PHI,SAS,W 134-99,240,56,98,0.571,41,69,0.594,15,29,0.517,7,11,0.636,134,36,85,0.424,32,64,0.5,4,21,0.19,23,31,0.742,99
229,2021/3/14,SAS,PHI,L 99-134,240,36,85,0.424,32,64,0.5,4,21,0.19,23,31,0.742,99,56,98,0.571,41,69,0.594,15,29,0.517,7,11,0.636,134
230,2021/3/13,ATL,SAC,W 121-106,240,43,84,0.512,31,51,0.608,12,33,0.364,23,33,0.697,121,43,98,0.439,36,62,0.581,7,36,0.194,13,16,0.813,106
231,2021/3/13,SAC,ATL,L 106-121,240,43,98,0.439,36,62,0.581,7,36,0.194,13,16,0.813,106,43,84,0.512,31,51,0.608,12,33,0.364,23,33,0.697,121
232,2021/3/13,BRK,DET,W 100-95,240,39,80,0.488,33,53,0.623,6,27,0.222,16,22,0.727,100,36,89,0.404,28,57,0.491,8,32,0.25,15,20,0.75,95
233,2021/3/13,DET,BRK,L 95-100,240,36,89,0.404,28,57,0.491,8,32,0.25,15,20,0.75,95,39,80,0.488,33,53,0.623,6,27,0.222,16,22,0.727,100
234,2021/3/13,CHO,TOR,W 114-104,240,39,81,0.481,18,32,0.563,21,49,0.429,15,19,0.789,114,37,96,0.385,22,50,0.44,15,46,0.326,15,18,0.833,104
235,2021/3/13,TOR,CHO,L 104-114,240,37,96,0.385,22,50,0.44,15,46,0.326,15,18,0.833,104,39,81,0.481,18,32,0.563,21,49,0.429,15,19,0.789,114
236,2021/3/13,DAL,DEN,W 116-103,240,42,86,0.488,24,40,0.6,18,46,0.391,14,16,0.875,116,37,90,0.411,21,49,0.429,16,41,0.39,13,18,0.722,103
237,2021/3/13,DEN,DAL,L 103-116,240,37,90,0.411,21,49,0.429,16,41,0.39,13,18,0.722,103,42,86,0.488,24,40,0.6,18,46,0.391,14,16,0.875,116
238,2021/3/13,MIN,POR,L 121-125,240,44,86,0.512,34,60,0.567,10,26,0.385,23,31,0.742,121,43,89,0.483,30,49,0.612,13,40,0.325,26,30,0.867,125
239,2021/3/13,POR,MIN,W 125-121,240,43,89,0.483,30,49,0.612,13,40,0.325,26,30,0.867,125,44,86,0.512,34,60,0.567,10,26,0.385,23,31,0.742,121
240,2021/3/13,NYK,OKC,W 119-97,240,44,90,0.489,30,55,0.545,14,35,0.4,17,22,0.773,119,37,76,0.487,29,44,0.659,8,32,0.25,15,21,0.714,97
241,2021/3/13,OKC,NYK,L 97-119,240,37,76,0.487,29,44,0.659,8,32,0.25,15,21,0.714,97,44,90,0.489,30,55,0.545,14,35,0.4,17,22,0.773,119
242,2021/3/13,IND,PHO,W 122-111,240,46,87,0.529,33,59,0.559,13,28,0.464,17,21,0.81,122,43,91,0.473,31,60,0.517,12,31,0.387,13,17,0.765,111
243,2021/3/13,PHO,IND,L 111-122,240,43,91,0.473,31,60,0.517,12,31,0.387,13,17,0.765,111,46,87,0.529,33,59,0.559,13,28,0.464,17,21,0.81,122
244,2021/3/13,MIL,WAS,W 125-119,240,43,99,0.434,26,54,0.481,17,45,0.378,22,25,0.88,125,43,94,0.457,27,53,0.509,16,41,0.39,17,22,0.773,119
245,2021/3/13,WAS,MIL,L 119-125,240,43,94,0.457,27,53,0.509,16,41,0.39,17,22,0.773,119,43,99,0.434,26,54,0.481,17,45,0.378,22,25,0.88,125
246,2021/3/12,CHI,MIA,L 90-101,240,34,92,0.37,19,54,0.352,15,38,0.395,7,7,1,90,37,80,0.463,25,45,0.556,12,35,0.343,15,20,0.75,101
247,2021/3/12,MIA,CHI,W 101-90,240,37,80,0.463,25,45,0.556,12,35,0.343,15,20,0.75,101,34,92,0.37,19,54,0.352,15,38,0.395,7,7,1,90
248,2021/3/12,IND,LAL,L 100-105,240,37,88,0.42,29,52,0.558,8,36,0.222,18,21,0.857,100,34,76,0.447,27,54,0.5,7,22,0.318,30,39,0.769,105
249,2021/3/12,LAL,IND,W 105-100,240,34,76,0.447,27,54,0.5,7,22,0.318,30,39,0.769,105,37,88,0.42,29,52,0.558,8,36,0.222,18,21,0.857,100
250,2021/3/12,DEN,MEM,W 103-102,240,41,92,0.446,28,55,0.509,13,37,0.351,8,11,0.727,103,40,87,0.46,26,59,0.441,14,28,0.5,8,8,1,102
251,2021/3/12,MEM,DEN,L 102-103,240,40,87,0.46,26,59,0.441,14,28,0.5,8,8,1,102,41,92,0.446,28,55,0.509,13,37,0.351,8,11,0.727,103
252,2021/3/12,CLE,NOP,L 82-116,240,30,88,0.341,23,56,0.411,7,32,0.219,15,20,0.75,82,47,101,0.465,41,77,0.532,6,24,0.25,16,19,0.842,116
253,2021/3/12,NOP,CLE,W 116-82,240,47,101,0.465,41,77,0.532,6,24,0.25,16,19,0.842,116,30,88,0.341,23,56,0.411,7,32,0.219,15,20,0.75,82
254,2021/3/12,ORL,SAS,L 77-104,240,29,80,0.363,19,42,0.452,10,38,0.263,9,12,0.75,77,40,89,0.449,30,60,0.5,10,29,0.345,14,18,0.778,104
255,2021/3/12,SAS,ORL,W 104-77,240,40,89,0.449,30,60,0.5,10,29,0.345,14,18,0.778,104,29,80,0.363,19,42,0.452,10,38,0.263,9,12,0.75,77
256,2021/3/12,HOU,UTA,L 99-114,240,41,112,0.366,32,69,0.464,9,43,0.209,8,13,0.615,99,39,81,0.481,24,41,0.585,15,40,0.375,21,25,0.84,114
257,2021/3/12,UTA,HOU,W 114-99,240,39,81,0.481,24,41,0.585,15,40,0.375,21,25,0.84,114,41,112,0.366,32,69,0.464,9,43,0.209,8,13,0.615,99
258,2021/3/12,PHI,WAS,W 127-101,240,49,90,0.544,38,69,0.551,11,21,0.524,18,18,1,127,40,82,0.488,32,58,0.552,8,24,0.333,13,22,0.591,101
259,2021/3/12,WAS,PHI,L 101-127,240,40,82,0.488,32,58,0.552,8,24,0.333,13,22,0.591,101,49,90,0.544,38,69,0.551,11,21,0.524,18,18,1,127
260,2021/3/11,BOS,BRK,L 109-121,240,41,91,0.451,28,51,0.549,13,40,0.325,14,22,0.636,109,42,88,0.477,23,46,0.5,19,42,0.452,18,22,0.818,121
261,2021/3/11,BRK,BOS,W 121-109,240,42,88,0.477,23,46,0.5,19,42,0.452,18,22,0.818,121,41,91,0.451,28,51,0.549,13,40,0.325,14,22,0.636,109
262,2021/3/11,CHI,PHI,L 105-127,240,39,83,0.47,25,54,0.463,14,29,0.483,13,16,0.813,105,53,103,0.515,43,70,0.614,10,33,0.303,11,15,0.733,127
263,2021/3/11,PHI,CHI,W 127-105,240,53,103,0.515,43,70,0.614,10,33,0.303,11,15,0.733,127,39,83,0.47,25,54,0.463,14,29,0.483,13,16,0.813,105
264,2021/3/11,CHO,DET,W 105-102,240,36,90,0.4,26,60,0.433,10,30,0.333,23,24,0.958,105,38,85,0.447,23,39,0.59,15,46,0.326,11,14,0.786,102
265,2021/3/11,DET,CHO,L 102-105,240,38,85,0.447,23,39,0.59,15,46,0.326,11,14,0.786,102,36,90,0.4,26,60,0.433,10,30,0.333,23,24,0.958,105
266,2021/3/11,GSW,LAC,L 104-130,240,38,88,0.432,29,52,0.558,9,36,0.25,19,27,0.704,104,44,96,0.458,26,55,0.473,18,41,0.439,24,29,0.828,130
267,2021/3/11,LAC,GSW,W 130-104,240,44,96,0.458,26,55,0.473,18,41,0.439,24,29,0.828,130,38,88,0.432,29,52,0.558,9,36,0.25,19,27,0.704,104
268,2021/3/11,MIA,ORL,W 111-103,240,41,91,0.451,25,42,0.595,16,49,0.327,13,22,0.591,111,39,96,0.406,27,62,0.435,12,34,0.353,13,15,0.867,103
269,2021/3/11,ORL,MIA,L 103-111,240,39,96,0.406,27,62,0.435,12,34,0.353,13,15,0.867,103,41,91,0.451,25,42,0.595,16,49,0.327,13,22,0.591,111
270,2021/3/11,MIL,NYK,W 134-101,240,50,87,0.575,32,49,0.653,18,38,0.474,16,17,0.941,134,37,88,0.42,24,51,0.471,13,37,0.351,14,21,0.667,101
271,2021/3/11,NYK,MIL,L 101-134,240,37,88,0.42,24,51,0.471,13,37,0.351,14,21,0.667,101,50,87,0.575,32,49,0.653,18,38,0.474,16,17,0.941,134
272,2021/3/11,MIN,NOP,W 135-105,240,51,95,0.537,32,55,0.582,19,40,0.475,14,16,0.875,135,43,100,0.43,37,68,0.544,6,32,0.188,13,24,0.542,105
273,2021/3/11,NOP,MIN,L 105-135,240,43,100,0.43,37,68,0.544,6,32,0.188,13,24,0.542,105,51,95,0.537,32,55,0.582,19,40,0.475,14,16,0.875,135
274,2021/3/11,DAL,OKC,L 108-116,240,35,82,0.427,20,48,0.417,15,34,0.441,23,33,0.697,108,41,91,0.451,25,59,0.424,16,32,0.5,18,20,0.9,116
275,2021/3/11,OKC,DAL,W 116-108,240,41,91,0.451,25,59,0.424,16,32,0.5,18,20,0.9,116,35,82,0.427,20,48,0.417,15,34,0.441,23,33,0.697,108
276,2021/3/11,PHO,POR,W 127-121,240,49,83,0.59,36,59,0.61,13,24,0.542,16,19,0.842,127,43,94,0.457,25,51,0.49,18,43,0.419,17,19,0.895,121
277,2021/3/11,POR,PHO,L 121-127,240,43,94,0.457,25,51,0.49,18,43,0.419,17,19,0.895,121,49,83,0.59,36,59,0.61,13,24,0.542,16,19,0.842,127
278,2021/3/11,HOU,SAC,L 105-125,240,41,99,0.414,30,54,0.556,11,45,0.244,12,17,0.706,105,45,92,0.489,34,59,0.576,11,33,0.333,24,28,0.857,125
279,2021/3/11,SAC,HOU,W 125-105,240,45,92,0.489,34,59,0.576,11,33,0.333,24,28,0.857,125,41,99,0.414,30,54,0.556,11,45,0.244,12,17,0.706,105
280,2021/3/11,ATL,TOR,W 121-120,240,39,90,0.433,24,48,0.5,15,42,0.357,28,35,0.8,121,42,96,0.438,25,59,0.424,17,37,0.459,19,23,0.826,120
281,2021/3/11,TOR,ATL,L 120-121,240,42,96,0.438,25,59,0.424,17,37,0.459,19,23,0.826,120,39,90,0.433,24,48,0.5,15,42,0.357,28,35,0.8,121
282,2021/3/10,DAL,SAS,W 115-104,240,43,83,0.518,30,43,0.698,13,40,0.325,16,19,0.842,115,38,83,0.458,26,55,0.473,12,28,0.429,16,20,0.8,104
283,2021/3/10,SAS,DAL,L 104-115,240,38,83,0.458,26,55,0.473,12,28,0.429,16,20,0.8,104,43,83,0.518,30,43,0.698,13,40,0.325,16,19,0.842,115
284,2021/3/10,MEM,WAS,W 127-112,240,50,99,0.505,42,76,0.553,8,23,0.348,19,29,0.655,127,38,95,0.4,27,59,0.458,11,36,0.306,25,27,0.926,112
285,2021/3/10,WAS,MEM,L 112-127,240,38,95,0.4,27,59,0.458,11,36,0.306,25,27,0.926,112,50,99,0.505,42,76,0.553,8,23,0.348,19,29,0.655,127
286,2021/3/4,BOS,TOR,W 132-125,240,45,74,0.608,32,45,0.711,13,29,0.448,29,40,0.725,132,45,91,0.495,24,41,0.585,21,50,0.42,14,17,0.824,125
287,2021/3/4,TOR,BOS,L 125-132,240,45,91,0.495,24,41,0.585,21,50,0.42,14,17,0.824,125,45,74,0.608,32,45,0.711,13,29,0.448,29,40,0.725,132
288,2021/3/4,DEN,IND,W 113-103,240,45,77,0.584,33,49,0.673,12,28,0.429,11,16,0.688,113,41,90,0.456,27,51,0.529,14,39,0.359,7,12,0.583,103
289,2021/3/4,IND,DEN,L 103-113,240,41,90,0.456,27,51,0.529,14,39,0.359,7,12,0.583,103,45,77,0.584,33,49,0.673,12,28,0.429,11,16,0.688,113
290,2021/3/4,MEM,MIL,L 111-112,240,40,101,0.396,32,67,0.478,8,34,0.235,23,24,0.958,111,42,95,0.442,32,61,0.525,10,34,0.294,18,22,0.818,112
291,2021/3/4,MIL,MEM,W 112-111,240,42,95,0.442,32,61,0.525,10,34,0.294,18,22,0.818,112,40,101,0.396,32,67,0.478,8,34,0.235,23,24,0.958,111
292,2021/3/4,MIA,NOP,W 103-93,240,36,73,0.493,26,43,0.605,10,30,0.333,21,25,0.84,103,33,84,0.393,22,41,0.537,11,43,0.256,16,20,0.8,93
293,2021/3/4,NOP,MIA,L 93-103,240,33,84,0.393,22,41,0.537,11,43,0.256,16,20,0.8,93,36,73,0.493,26,43,0.605,10,30,0.333,21,25,0.84,103
294,2021/3/4,DET,NYK,L 104-114,240,39,80,0.488,25,44,0.568,14,36,0.389,12,15,0.8,104,45,83,0.542,36,56,0.643,9,27,0.333,15,19,0.789,114
295,2021/3/4,NYK,DET,W 114-104,240,45,83,0.542,36,56,0.643,9,27,0.333,15,19,0.789,114,39,80,0.488,25,44,0.568,14,36,0.389,12,15,0.8,104
296,2021/3/4,GSW,PHO,L 98-120,240,38,88,0.432,26,53,0.491,12,35,0.343,10,16,0.625,98,49,96,0.51,37,66,0.561,12,30,0.4,10,13,0.769,120
297,2021/3/4,PHO,GSW,W 120-98,240,49,96,0.51,37,66,0.561,12,30,0.4,10,13,0.769,120,38,88,0.432,26,53,0.491,12,35,0.343,10,16,0.625,98
298,2021/3/4,POR,SAC,W 123-119,240,42,88,0.477,27,50,0.54,15,38,0.395,24,25,0.96,123,49,103,0.476,38,74,0.514,11,29,0.379,10,16,0.625,119
299,2021/3/4,SAC,POR,L 119-123,240,49,103,0.476,38,74,0.514,11,29,0.379,10,16,0.625,119,42,88,0.477,27,50,0.54,15,38,0.395,24,25,0.96,123
300,2021/3/4,OKC,SAS,W 107-102,240,37,85,0.435,25,45,0.556,12,40,0.3,21,26,0.808,107,40,85,0.471,30,54,0.556,10,31,0.323,12,12,1,102
301,2021/3/4,SAS,OKC,L 102-107,240,40,85,0.471,30,54,0.556,10,31,0.323,12,12,1,102,37,85,0.435,25,45,0.556,12,40,0.3,21,26,0.808,107
302,2021/3/4,LAC,WAS,L 117-119,240,38,82,0.463,22,47,0.468,16,35,0.457,25,27,0.926,117,40,88,0.455,31,65,0.477,9,23,0.391,30,42,0.714,119
303,2021/3/4,WAS,LAC,W 119-117,240,40,88,0.455,31,65,0.477,9,23,0.391,30,42,0.714,119,38,82,0.463,22,47,0.468,16,35,0.457,25,27,0.926,117
304,2021/3/3,CLE,IND,L 111-114,240,43,83,0.518,32,55,0.582,11,28,0.393,14,15,0.933,111,47,83,0.566,39,58,0.672,8,25,0.32,12,16,0.75,114
305,2021/3/3,IND,CLE,W 114-111,240,47,83,0.566,39,58,0.672,8,25,0.32,12,16,0.75,114,43,83,0.518,32,55,0.582,11,28,0.393,14,15,0.933,111
306,2021/3/3,DAL,OKC,W 87-78,240,32,83,0.386,24,43,0.558,8,40,0.2,15,19,0.789,87,29,87,0.333,20,48,0.417,9,39,0.231,11,17,0.647,78
307,2021/3/3,OKC,DAL,L 78-87,240,29,87,0.333,20,48,0.417,9,39,0.231,11,17,0.647,78,32,83,0.386,24,43,0.558,8,40,0.2,15,19,0.789,87
308,2021/3/3,BRK,HOU,W 132-114,240,49,85,0.576,32,50,0.64,17,35,0.486,17,24,0.708,132,38,91,0.418,20,48,0.417,18,43,0.419,20,28,0.714,114
309,2021/3/3,HOU,BRK,L 114-132,240,38,91,0.418,20,48,0.417,18,43,0.419,20,28,0.714,114,49,85,0.576,32,50,0.64,17,35,0.486,17,24,0.708,132
310,2021/3/3,CHO,MIN,W 135-102,240,51,98,0.52,34,59,0.576,17,39,0.436,16,21,0.762,135,39,96,0.406,30,56,0.536,9,40,0.225,15,18,0.833,102
311,2021/3/3,MIN,CHO,L 102-135,240,39,96,0.406,30,56,0.536,9,40,0.225,15,18,0.833,102,51,98,0.52,34,59,0.576,17,39,0.436,16,21,0.762,135
312,2021/3/3,CHI,NOP,W 128-124,240,48,94,0.511,36,66,0.545,12,28,0.429,20,22,0.909,128,46,83,0.554,40,61,0.656,6,22,0.273,26,38,0.684,124
313,2021/3/3,NOP,CHI,L 124-128,240,46,83,0.554,40,61,0.656,6,22,0.273,26,38,0.684,124,48,94,0.511,36,66,0.545,12,28,0.429,20,22,0.909,128
314,2021/3/3,ATL,ORL,W 115-112,240,38,85,0.447,17,40,0.425,21,45,0.467,18,19,0.947,115,36,84,0.429,23,49,0.469,13,35,0.371,27,27,1,112
315,2021/3/3,ORL,ATL,L 112-115,240,36,84,0.429,23,49,0.469,13,35,0.371,27,27,1,112,38,85,0.447,17,40,0.425,21,45,0.467,18,19,0.947,115
316,2021/3/3,PHI,UTA,W 131-123 (OT),265,48,93,0.516,40,68,0.588,8,25,0.32,27,35,0.771,131,44,100,0.44,23,56,0.411,21,44,0.477,14,19,0.737,123
317,2021/3/3,UTA,PHI,L 123-131 (OT),265,44,100,0.44,23,56,0.411,21,44,0.477,14,19,0.737,123,48,93,0.516,40,68,0.588,8,25,0.32,27,35,0.771,131
318,2021/3/3,GSW,POR,L 106-108,240,41,97,0.423,26,55,0.473,15,42,0.357,9,14,0.643,106,36,86,0.419,22,37,0.595,14,49,0.286,22,26,0.846,108
319,2021/3/3,POR,GSW,W 108-106,240,36,86,0.419,22,37,0.595,14,49,0.286,22,26,0.846,108,41,97,0.423,26,55,0.473,15,42,0.357,9,14,0.643,106
320,2021/3/3,LAL,SAC,L 120-123,240,49,93,0.527,37,66,0.561,12,27,0.444,10,14,0.714,120,48,80,0.6,36,55,0.655,12,25,0.48,15,19,0.789,123
321,2021/3/3,SAC,LAL,W 123-120,240,48,80,0.6,36,55,0.655,12,25,0.48,15,19,0.789,123,49,93,0.527,37,66,0.561,12,27,0.444,10,14,0.714,120
322,2021/3/3,DET,TOR,W 129-105,240,48,91,0.527,28,50,0.56,20,41,0.488,13,21,0.619,129,34,77,0.442,22,41,0.537,12,36,0.333,25,30,0.833,105
323,2021/3/3,TOR,DET,L 105-129,240,34,77,0.442,22,41,0.537,12,36,0.333,25,30,0.833,105,48,91,0.527,28,50,0.56,20,41,0.488,13,21,0.619,129
324,2021/3/2,BOS,LAC,W 117-112,240,42,86,0.488,26,54,0.481,16,32,0.5,17,23,0.739,117,43,87,0.494,25,49,0.51,18,38,0.474,8,9,0.889,112
325,2021/3/2,LAC,BOS,L 112-117,240,43,87,0.494,25,49,0.51,18,38,0.474,8,9,0.889,112,42,86,0.488,26,54,0.481,16,32,0.5,17,23,0.739,117
326,2021/3/2,LAL,PHO,L 104-114,240,40,79,0.506,29,48,0.604,11,31,0.355,13,17,0.765,104,38,77,0.494,22,48,0.458,16,29,0.552,22,25,0.88,114
327,2021/3/2,PHO,LAL,W 114-104,240,38,77,0.494,22,48,0.458,16,29,0.552,22,25,0.88,114,40,79,0.506,29,48,0.604,11,31,0.355,13,17,0.765,104
328,2021/3/2,ATL,MIA,W 94-80,240,34,71,0.479,21,35,0.6,13,36,0.361,13,15,0.867,94,28,75,0.373,19,42,0.452,9,33,0.273,15,22,0.682,80
329,2021/3/2,MIA,ATL,L 80-94,240,28,75,0.373,19,42,0.452,9,33,0.273,15,22,0.682,80,34,71,0.479,21,35,0.6,13,36,0.361,13,15,0.867,94
330,2021/3/2,DEN,MIL,W 128-97,240,53,95,0.558,42,65,0.646,11,30,0.367,11,12,0.917,128,32,79,0.405,21,39,0.538,11,40,0.275,22,31,0.71,97
331,2021/3/2,MIL,DEN,L 97-128,240,32,79,0.405,21,39,0.538,11,40,0.275,22,31,0.71,97,53,95,0.558,42,65,0.646,11,30,0.367,11,12,0.917,128
332,2021/3/2,NYK,SAS,L 93-119,240,33,81,0.407,18,45,0.4,15,36,0.417,12,15,0.8,93,43,89,0.483,25,47,0.532,18,42,0.429,15,21,0.714,119
333,2021/3/2,SAS,NYK,W 119-93,240,43,89,0.483,25,47,0.532,18,42,0.429,15,21,0.714,119,33,81,0.407,18,45,0.4,15,36,0.417,12,15,0.8,93
334,2021/3/2,MEM,WAS,W 125-111,240,47,95,0.495,34,66,0.515,13,29,0.448,18,23,0.783,125,41,81,0.506,30,50,0.6,11,31,0.355,18,25,0.72,111
335,2021/3/2,WAS,MEM,L 111-125,240,41,81,0.506,30,50,0.6,11,31,0.355,18,25,0.72,111,47,95,0.495,34,66,0.515,13,29,0.448,18,23,0.783,125
336,2021/3/1,CHI,DEN,L 112-118,240,42,94,0.447,30,56,0.536,12,38,0.316,16,22,0.727,112,46,87,0.529,36,60,0.6,10,27,0.37,16,20,0.8,118
337,2021/3/1,DEN,CHI,W 118-112,240,46,87,0.529,36,60,0.6,10,27,0.37,16,20,0.8,118,42,94,0.447,30,56,0.536,12,38,0.316,16,22,0.727,112
338,2021/3/1,CLE,HOU,W 101-90,240,36,73,0.493,26,43,0.605,10,30,0.333,19,24,0.792,101,31,76,0.408,21,45,0.467,10,31,0.323,18,24,0.75,90
339,2021/3/1,HOU,CLE,L 90-101,240,31,76,0.408,21,45,0.467,10,31,0.323,18,24,0.75,90,36,73,0.493,26,43,0.605,10,30,0.333,19,24,0.792,101
340,2021/3/1,NOP,UTA,W 129-124,240,52,92,0.565,45,81,0.556,7,11,0.636,18,23,0.783,129,46,101,0.455,29,58,0.5,17,43,0.395,15,18,0.833,124
341,2021/3/1,UTA,NOP,L 124-129,240,46,101,0.455,29,58,0.5,17,43,0.395,15,18,0.833,124,52,92,0.565,45,81,0.556,7,11,0.636,18,23,0.783,129
342,2021/3/1,DAL,ORL,W 130-124,240,47,90,0.522,30,44,0.682,17,46,0.37,19,23,0.826,130,47,95,0.495,27,54,0.5,20,41,0.488,10,14,0.714,124
343,2021/3/1,ORL,DAL,L 124-130,240,47,95,0.495,27,54,0.5,20,41,0.488,10,14,0.714,124,47,90,0.522,30,44,0.682,17,46,0.37,19,23,0.826,130
344,2021/3/1,IND,PHI,L 114-130,240,44,91,0.484,36,62,0.581,8,29,0.276,18,21,0.857,114,50,88,0.568,35,53,0.66,15,35,0.429,15,16,0.938,130
345,2021/3/1,PHI,IND,W 130-114,240,50,88,0.568,35,53,0.66,15,35,0.429,15,16,0.938,130,44,91,0.484,36,62,0.581,8,29,0.276,18,21,0.857,114
346,2021/3/1,CHO,POR,L 111-123,240,43,88,0.489,28,54,0.519,15,34,0.441,10,17,0.588,111,46,86,0.535,22,40,0.55,24,46,0.522,7,10,0.7,123
347,2021/3/1,POR,CHO,W 123-111,240,46,86,0.535,22,40,0.55,24,46,0.522,7,10,0.7,123,43,88,0.489,28,54,0.519,15,34,0.441,10,17,0.588,111
348,2021/3/1,BRK,SAS,W 124-113 (OT),265,47,100,0.47,30,59,0.508,17,41,0.415,13,17,0.765,124,44,97,0.454,29,62,0.468,15,35,0.429,10,15,0.667,113
349,2021/3/1,SAS,BRK,L 113-124 (OT),265,44,97,0.454,29,62,0.468,15,35,0.429,10,15,0.667,113,47,100,0.47,30,59,0.508,17,41,0.415,13,17,0.765,124
350,2021/2/28,BOS,WAS,W 111-110,240,42,89,0.472,32,59,0.542,10,30,0.333,17,24,0.708,111,38,84,0.452,29,52,0.558,9,32,0.281,25,29,0.862,110
351,2021/2/28,WAS,BOS,L 110-111,240,38,84,0.452,29,52,0.558,9,32,0.281,25,29,0.862,110,42,89,0.472,32,59,0.542,10,30,0.333,17,24,0.708,111
352,2021/2/28,DET,NYK,L 90-109,240,28,72,0.389,19,40,0.475,9,32,0.281,25,31,0.806,90,44,86,0.512,31,60,0.517,13,26,0.5,8,10,0.8,109
353,2021/2/28,NYK,DET,W 109-90,240,44,86,0.512,31,60,0.517,13,26,0.5,8,10,0.8,109,28,72,0.389,19,40,0.475,9,32,0.281,25,31,0.806,90
354,2021/2/28,HOU,MEM,L 84-133,240,23,83,0.277,19,38,0.5,4,45,0.089,34,41,0.829,84,50,94,0.532,40,64,0.625,10,30,0.333,23,28,0.821,133
355,2021/2/28,MEM,HOU,W 133-84,240,50,94,0.532,40,64,0.625,10,30,0.333,23,28,0.821,133,23,83,0.277,19,38,0.5,4,45,0.089,34,41,0.829,84
356,2021/2/28,GSW,LAL,L 91-117,240,35,86,0.407,27,52,0.519,8,34,0.235,13,19,0.684,91,40,85,0.471,29,54,0.537,11,31,0.355,26,38,0.684,117
357,2021/2/28,LAL,GSW,W 117-91,240,40,85,0.471,29,54,0.537,11,31,0.355,26,38,0.684,117,35,86,0.407,27,52,0.519,8,34,0.235,13,19,0.684,91
358,2021/2/28,ATL,MIA,L 99-109,240,36,87,0.414,28,52,0.538,8,35,0.229,19,22,0.864,99,39,86,0.453,28,49,0.571,11,37,0.297,20,22,0.909,109
359,2021/2/28,MIA,ATL,W 109-99,240,39,86,0.453,28,49,0.571,11,37,0.297,20,22,0.909,109,36,87,0.414,28,52,0.538,8,35,0.229,19,22,0.864,99
360,2021/2/28,LAC,MIL,L 100-105,240,40,97,0.412,26,53,0.491,14,44,0.318,6,7,0.857,100,38,85,0.447,26,47,0.553,12,38,0.316,17,22,0.773,105
361,2021/2/28,MIL,LAC,W 105-100,240,38,85,0.447,26,47,0.553,12,38,0.316,17,22,0.773,105,40,97,0.412,26,53,0.491,14,44,0.318,6,7,0.857,100
362,2021/2/28,MIN,PHO,L 99-118,240,35,93,0.376,27,58,0.466,8,35,0.229,21,24,0.875,99,44,89,0.494,37,62,0.597,7,27,0.259,23,24,0.958,118
363,2021/2/28,PHO,MIN,W 118-99,240,44,89,0.494,37,62,0.597,7,27,0.259,23,24,0.958,118,35,93,0.376,27,58,0.466,8,35,0.229,21,24,0.875,99
364,2021/2/28,CHO,SAC,W 127-126,240,45,83,0.542,34,53,0.642,11,30,0.367,26,27,0.963,127,50,92,0.543,34,56,0.607,16,36,0.444,10,17,0.588,126
365,2021/2/28,SAC,CHO,L 126-127,240,50,92,0.543,34,56,0.607,16,36,0.444,10,17,0.588,126,45,83,0.542,34,53,0.642,11,30,0.367,26,27,0.963,127
366,2021/2/27,BRK,DAL,L 98-115,240,35,86,0.407,21,42,0.5,14,44,0.318,14,19,0.737,98,45,86,0.523,31,50,0.62,14,36,0.389,11,17,0.647,115
367,2021/2/27,DAL,BRK,W 115-98,240,45,86,0.523,31,50,0.62,14,36,0.389,11,17,0.647,115,35,86,0.407,21,42,0.5,14,44,0.318,14,19,0.737,98
368,2021/2/27,IND,NYK,L 107-110,240,38,84,0.452,27,56,0.482,11,28,0.393,20,25,0.8,107,40,81,0.494,28,57,0.491,12,24,0.5,18,22,0.818,110
369,2021/2/27,NYK,IND,W 110-107,240,40,81,0.494,28,57,0.491,12,24,0.5,18,22,0.818,110,38,84,0.452,27,56,0.482,11,28,0.393,20,25,0.8,107
370,2021/2/27,DEN,OKC,W 126-96,240,49,89,0.551,34,58,0.586,15,31,0.484,13,16,0.813,126,37,88,0.42,26,41,0.634,11,47,0.234,11,15,0.733,96
371,2021/2/27,OKC,DEN,L 96-126,240,37,88,0.42,26,41,0.634,11,47,0.234,11,15,0.733,96,49,89,0.551,34,58,0.586,15,31,0.484,13,16,0.813,126
372,2021/2/27,ORL,UTA,L 109-124,240,44,96,0.458,30,62,0.484,14,34,0.412,7,8,0.875,109,45,85,0.529,28,40,0.7,17,45,0.378,17,24,0.708,124
373,2021/2/27,UTA,ORL,W 124-109,240,45,85,0.529,28,40,0.7,17,45,0.378,17,24,0.708,124,44,96,0.458,30,62,0.484,14,34,0.412,7,8,0.875,109
374,2021/2/27,CLE,PHI,W 112-109 (OT),265,41,97,0.423,33,73,0.452,8,24,0.333,22,29,0.759,112,38,83,0.458,28,55,0.509,10,28,0.357,23,35,0.657,109
375,2021/2/27,PHI,CLE,L 109-112 (OT),265,38,83,0.458,28,55,0.509,10,28,0.357,23,35,0.657,109,41,97,0.423,33,73,0.452,8,24,0.333,22,29,0.759,112
376,2021/2/27,NOP,SAS,L 114-117,240,40,91,0.44,31,59,0.525,9,32,0.281,25,31,0.806,114,41,86,0.477,29,54,0.537,12,32,0.375,23,28,0.821,117
377,2021/2/27,SAS,NOP,W 117-114,240,41,86,0.477,29,54,0.537,12,32,0.375,23,28,0.821,117,40,91,0.44,31,59,0.525,9,32,0.281,25,31,0.806,114
378,2021/2/27,MIN,WAS,L 112-128,240,41,95,0.432,30,60,0.5,11,35,0.314,19,29,0.655,112,44,98,0.449,31,65,0.477,13,33,0.394,27,34,0.794,128
379,2021/2/27,WAS,MIN,W 128-112,240,44,98,0.449,31,65,0.477,13,33,0.394,27,34,0.794,128,41,95,0.432,30,60,0.5,11,35,0.314,19,29,0.655,112
380,2021/2/26,BOS,IND,W 118-112,240,42,82,0.512,33,60,0.55,9,22,0.409,25,29,0.862,118,35,89,0.393,20,43,0.465,15,46,0.326,27,29,0.931,112
381,2021/2/26,IND,BOS,L 112-118,240,35,89,0.393,20,43,0.465,15,46,0.326,27,29,0.931,112,42,82,0.512,33,60,0.55,9,22,0.409,25,29,0.862,118
382,2021/2/26,CHI,PHO,L 97-106,240,39,78,0.5,27,47,0.574,12,31,0.387,7,10,0.7,97,44,88,0.5,38,66,0.576,6,22,0.273,12,15,0.8,106
383,2021/2/26,PHO,CHI,W 106-97,240,44,88,0.5,38,66,0.576,6,22,0.273,12,15,0.8,106,39,78,0.5,27,47,0.574,12,31,0.387,7,10,0.7,97
384,2021/2/26,DET,SAC,L 107-110,240,37,82,0.451,25,49,0.51,12,33,0.364,21,32,0.656,107,37,89,0.416,30,57,0.526,7,32,0.219,29,41,0.707,110
385,2021/2/26,SAC,DET,W 110-107,240,37,89,0.416,30,57,0.526,7,32,0.219,29,41,0.707,110,37,82,0.451,25,49,0.51,12,33,0.364,21,32,0.656,107
386,2021/2/26,CHO,GSW,L 121-130,240,41,89,0.461,24,48,0.5,17,41,0.415,22,32,0.688,121,48,79,0.608,37,55,0.673,11,24,0.458,23,25,0.92,130
387,2021/2/26,GSW,CHO,W 130-121,240,48,79,0.608,37,55,0.673,11,24,0.458,23,25,0.92,130,41,89,0.461,24,48,0.5,17,41,0.415,22,32,0.688,121
388,2021/2/26,LAL,POR,W 102-93,240,37,88,0.42,30,61,0.492,7,27,0.259,21,28,0.75,102,32,83,0.386,21,46,0.457,11,37,0.297,18,20,0.9,93
389,2021/2/26,POR,LAL,L 93-102,240,32,83,0.386,21,46,0.457,11,37,0.297,18,20,0.9,93,37,88,0.42,30,61,0.492,7,27,0.259,21,28,0.75,102
390,2021/2/26,LAC,MEM,W 119-99,240,44,80,0.55,30,45,0.667,14,35,0.4,17,18,0.944,119,39,97,0.402,30,69,0.435,9,28,0.321,12,16,0.75,99
391,2021/2/26,MEM,LAC,L 99-119,240,39,97,0.402,30,69,0.435,9,28,0.321,12,16,0.75,99,44,80,0.55,30,45,0.667,14,35,0.4,17,18,0.944,119
392,2021/2/26,MIA,UTA,W 124-116,240,44,86,0.512,30,55,0.545,14,31,0.452,22,25,0.88,124,40,94,0.426,25,48,0.521,15,46,0.326,21,23,0.913,116
393,2021/2/26,UTA,MIA,L 116-124,240,40,94,0.426,25,48,0.521,15,46,0.326,21,23,0.913,116,44,86,0.512,30,55,0.545,14,31,0.452,22,25,0.88,124
394,2021/2/26,ATL,OKC,L 109-118,240,43,97,0.443,31,57,0.544,12,40,0.3,11,17,0.647,109,46,88,0.523,30,46,0.652,16,42,0.381,10,16,0.625,118
395,2021/2/26,OKC,ATL,W 118-109,240,46,88,0.523,30,46,0.652,16,42,0.381,10,16,0.625,118,43,97,0.443,31,57,0.544,12,40,0.3,11,17,0.647,109
396,2021/2/26,HOU,TOR,L 111-122,240,39,91,0.429,23,44,0.523,16,47,0.34,17,20,0.85,111,40,89,0.449,24,48,0.5,16,41,0.39,26,27,0.963,122
397,2021/2/26,TOR,HOU,W 122-111,240,40,89,0.449,24,48,0.5,16,41,0.39,26,27,0.963,122,39,91,0.429,23,44,0.523,16,47,0.34,17,20,0.85,111
398,2021/2/25,BRK,ORL,W 129-92,240,49,92,0.533,29,47,0.617,20,45,0.444,11,14,0.786,129,35,87,0.402,26,51,0.51,9,36,0.25,13,15,0.867,92
399,2021/2/25,ORL,BRK,L 92-129,240,35,87,0.402,26,51,0.51,9,36,0.25,13,15,0.867,92,49,92,0.533,29,47,0.617,20,45,0.444,11,14,0.786,129
400,2021/2/25,DEN,WAS,L 110-112,240,37,85,0.435,22,47,0.468,15,38,0.395,21,24,0.875,110,41,86,0.477,33,60,0.55,8,26,0.308,22,25,0.88,112
401,2021/2/25,WAS,DEN,W 112-110,240,41,86,0.477,33,60,0.55,8,26,0.308,22,25,0.88,112,37,85,0.435,22,47,0.468,15,38,0.395,21,24,0.875,110
402,2021/2/25,LAC,MEM,L 94-122,240,34,84,0.405,22,50,0.44,12,34,0.353,14,16,0.875,94,50,92,0.543,39,73,0.534,11,19,0.579,11,16,0.688,122
403,2021/2/25,MEM,LAC,W 122-94,240,50,92,0.543,39,73,0.534,11,19,0.579,11,16,0.688,122,34,84,0.405,22,50,0.44,12,34,0.353,14,16,0.875,94
404,2021/2/25,MIL,NOP,W 129-125,240,52,96,0.542,39,65,0.6,13,31,0.419,12,16,0.75,129,51,102,0.5,38,63,0.603,13,39,0.333,10,14,0.714,125
405,2021/2/25,NOP,MIL,L 125-129,240,51,102,0.5,38,63,0.603,13,39,0.333,10,14,0.714,125,52,96,0.542,39,65,0.6,13,31,0.419,12,16,0.75,129
406,2021/2/25,NYK,SAC,W 140-121,240,51,87,0.586,32,51,0.627,19,36,0.528,19,21,0.905,140,42,85,0.494,30,50,0.6,12,35,0.343,25,33,0.758,121
407,2021/2/25,SAC,NYK,L 121-140,240,42,85,0.494,30,50,0.6,12,35,0.343,25,33,0.758,121,51,87,0.586,32,51,0.627,19,36,0.528,19,21,0.905,140
408,2021/2/25,DAL,PHI,L 97-111,240,32,78,0.41,19,44,0.432,13,34,0.382,20,23,0.87,97,39,90,0.433,27,61,0.443,12,29,0.414,21,25,0.84,111
409,2021/2/25,PHI,DAL,W 111-97,240,39,90,0.433,27,61,0.443,12,29,0.414,21,25,0.84,111,32,78,0.41,19,44,0.432,13,34,0.382,20,23,0.87,97
410,2021/2/24,ATL,BOS,W 127-112,240,45,85,0.529,22,43,0.512,23,42,0.548,14,17,0.824,127,42,95,0.442,34,64,0.531,8,31,0.258,20,23,0.87,112
411,2021/2/24,BOS,ATL,L 112-127,240,42,95,0.442,34,64,0.531,8,31,0.258,20,23,0.87,112,45,85,0.529,22,43,0.512,23,42,0.548,14,17,0.824,127
412,2021/2/24,CHI,MIN,W 133-126 (OT),265,55,93,0.591,45,68,0.662,10,25,0.4,13,16,0.813,133,47,104,0.452,35,66,0.53,12,38,0.316,20,21,0.952,126
413,2021/2/24,MIN,CHI,L 126-133 (OT),265,47,104,0.452,35,66,0.53,12,38,0.316,20,21,0.952,126,55,93,0.591,45,68,0.662,10,25,0.4,13,16,0.813,133
414,2021/2/24,CLE,HOU,W 112-96,240,43,85,0.506,27,49,0.551,16,36,0.444,10,15,0.667,112,36,90,0.4,26,57,0.456,10,33,0.303,14,17,0.824,96
415,2021/2/24,HOU,CLE,L 96-112,240,36,90,0.4,26,57,0.456,10,33,0.303,14,17,0.824,96,43,85,0.506,27,49,0.551,16,36,0.444,10,15,0.667,112
416,2021/2/24,GSW,IND,W 111-107,240,39,83,0.47,34,57,0.596,5,26,0.192,28,31,0.903,111,37,81,0.457,30,52,0.577,7,29,0.241,26,32,0.813,107
417,2021/2/24,IND,GSW,L 107-111,240,37,81,0.457,30,52,0.577,7,29,0.241,26,32,0.813,107,39,83,0.47,34,57,0.596,5,26,0.192,28,31,0.903,111
418,2021/2/24,MIA,TOR,W 116-108,240,37,80,0.463,20,42,0.476,17,38,0.447,25,29,0.862,116,37,74,0.5,17,30,0.567,20,44,0.455,14,17,0.824,108
419,2021/2/24,TOR,MIA,L 108-116,240,37,74,0.5,17,30,0.567,20,44,0.455,14,17,0.824,108,37,80,0.463,20,42,0.476,17,38,0.447,25,29,0.862,116
420,2021/2/24,DET,NOP,L 118-128,240,47,89,0.528,34,53,0.642,13,36,0.361,11,16,0.688,118,50,90,0.556,40,67,0.597,10,23,0.435,18,29,0.621,128
421,2021/2/24,NOP,DET,W 128-118,240,50,90,0.556,40,67,0.597,10,23,0.435,18,29,0.621,128,47,89,0.528,34,53,0.642,13,36,0.361,11,16,0.688,118
422,2021/2/24,OKC,SAS,W 102-99,240,37,89,0.416,19,45,0.422,18,44,0.409,10,11,0.909,102,40,86,0.465,31,61,0.508,9,25,0.36,10,15,0.667,99
423,2021/2/24,SAS,OKC,L 99-102,240,40,86,0.465,31,61,0.508,9,25,0.36,10,15,0.667,99,37,89,0.416,19,45,0.422,18,44,0.409,10,11,0.909,102
424,2021/2/24,CHO,PHO,W 124-121,240,43,88,0.489,30,52,0.577,13,36,0.361,25,27,0.926,124,44,87,0.506,30,49,0.612,14,38,0.368,19,27,0.704,121
425,2021/2/24,PHO,CHO,L 121-124,240,44,87,0.506,30,49,0.612,14,38,0.368,19,27,0.704,121,43,88,0.489,30,52,0.577,13,36,0.361,25,27,0.926,124
426,2021/2/24,LAL,UTA,L 89-114,240,34,85,0.4,26,52,0.5,8,33,0.242,13,20,0.65,89,41,87,0.471,19,39,0.487,22,48,0.458,10,15,0.667,114
427,2021/2/24,UTA,LAL,W 114-89,240,41,87,0.471,19,39,0.487,22,48,0.458,10,15,0.667,114,34,85,0.4,26,52,0.5,8,33,0.242,13,20,0.65,89
428,2021/2/23,BRK,SAC,W 127-118,240,44,89,0.494,27,49,0.551,17,40,0.425,22,31,0.71,127,45,87,0.517,30,56,0.536,15,31,0.484,13,19,0.684,118
429,2021/2/23,SAC,BRK,L 118-127,240,45,87,0.517,30,56,0.536,15,31,0.484,13,19,0.684,118,44,89,0.494,27,49,0.551,17,40,0.425,22,31,0.71,127
430,2021/2/23,ATL,CLE,L 111-112,240,40,89,0.449,26,58,0.448,14,31,0.452,17,23,0.739,111,41,78,0.526,26,50,0.52,15,28,0.536,15,19,0.789,112
431,2021/2/23,CLE,ATL,W 112-111,240,41,78,0.526,26,50,0.52,15,28,0.536,15,19,0.789,112,40,89,0.449,26,58,0.448,14,31,0.452,17,23,0.739,111
432,2021/2/23,BOS,DAL,L 107-110,240,41,86,0.477,29,47,0.617,12,39,0.308,13,18,0.722,107,42,89,0.472,29,56,0.518,13,33,0.394,13,15,0.867,110
433,2021/2/23,DAL,BOS,W 110-107,240,42,89,0.472,29,56,0.518,13,33,0.394,13,15,0.867,110,41,86,0.477,29,47,0.617,12,39,0.308,13,18,0.722,107
434,2021/2/23,DEN,POR,W 111-106,240,40,94,0.426,26,58,0.448,14,36,0.389,17,18,0.944,111,41,87,0.471,27,46,0.587,14,41,0.341,10,10,1,106
435,2021/2/23,POR,DEN,L 106-111,240,41,87,0.471,27,46,0.587,14,41,0.341,10,10,1,106,40,94,0.426,26,58,0.448,14,36,0.389,17,18,0.944,111
436,2021/2/23,LAC,WAS,W 135-116,240,54,94,0.574,35,56,0.625,19,38,0.5,8,13,0.615,135,47,88,0.534,36,68,0.529,11,20,0.55,11,16,0.688,116
437,2021/2/23,WAS,LAC,L 116-135,240,47,88,0.534,36,68,0.529,11,20,0.55,11,16,0.688,116,54,94,0.574,35,56,0.625,19,38,0.5,8,13,0.615,135
438,2021/2/23,MIL,MIN,W 139-112,240,53,99,0.535,33,57,0.579,20,42,0.476,13,18,0.722,139,42,98,0.429,23,44,0.523,19,54,0.352,9,9,1,112
439,2021/2/23,MIN,MIL,L 112-139,240,42,98,0.429,23,44,0.523,19,54,0.352,9,9,1,112,53,99,0.535,33,57,0.579,20,42,0.476,13,18,0.722,139
440,2021/2/23,GSW,NYK,W 114-106,240,40,89,0.449,27,51,0.529,13,38,0.342,21,24,0.875,114,38,97,0.392,27,68,0.397,11,29,0.379,19,22,0.864,106
441,2021/2/23,NYK,GSW,L 106-114,240,38,97,0.392,27,68,0.397,11,29,0.379,19,22,0.864,106,40,89,0.449,27,51,0.529,13,38,0.342,21,24,0.875,114
442,2021/2/23,DET,ORL,W 105-93,240,41,88,0.466,31,54,0.574,10,34,0.294,13,16,0.813,105,33,88,0.375,19,50,0.38,14,38,0.368,13,22,0.591,93
443,2021/2/23,ORL,DET,L 93-105,240,33,88,0.375,19,50,0.38,14,38,0.368,13,22,0.591,93,41,88,0.466,31,54,0.574,10,34,0.294,13,16,0.813,105
444,2021/2/23,PHI,TOR,W 109-102,240,33,80,0.413,16,42,0.381,17,38,0.447,26,30,0.867,109,40,93,0.43,29,56,0.518,11,37,0.297,11,13,0.846,102
445,2021/2/23,TOR,PHI,L 102-109,240,40,93,0.43,29,56,0.518,11,37,0.297,11,13,0.846,102,33,80,0.413,16,42,0.381,17,38,0.447,26,30,0.867,109
446,2021/2/22,DAL,MEM,W 102-92,240,35,80,0.438,20,39,0.513,15,41,0.366,17,26,0.654,102,37,94,0.394,31,63,0.492,6,31,0.194,12,19,0.632,92
447,2021/2/22,MEM,DAL,L 92-102,240,37,94,0.394,31,63,0.492,6,31,0.194,12,19,0.632,92,35,80,0.438,20,39,0.513,15,41,0.366,17,26,0.654,102
448,2021/2/22,CHI,HOU,W 120-100,240,49,91,0.538,34,55,0.618,15,36,0.417,7,10,0.7,120,37,96,0.385,24,56,0.429,13,40,0.325,13,19,0.684,100
449,2021/2/22,HOU,CHI,L 100-120,240,37,96,0.385,24,56,0.429,13,40,0.325,13,19,0.684,100,49,91,0.538,34,55,0.618,15,36,0.417,7,10,0.7,120
450,2021/2/22,LAL,WAS,L 124-127 (OT),265,49,104,0.471,34,60,0.567,15,44,0.341,11,17,0.647,124,47,96,0.49,38,71,0.535,9,25,0.36,24,33,0.727,127
451,2021/2/22,WAS,LAL,W 127-124 (OT),265,47,96,0.49,38,71,0.535,9,25,0.36,24,33,0.727,127,49,104,0.471,34,60,0.567,15,44,0.341,11,17,0.647,124
452,2021/2/22,MIA,OKC,W 108-94,240,36,81,0.444,21,41,0.512,15,40,0.375,21,25,0.84,108,32,74,0.432,18,35,0.514,14,39,0.359,16,19,0.842,94
453,2021/2/22,OKC,MIA,L 94-108,240,32,74,0.432,18,35,0.514,14,39,0.359,16,19,0.842,94,36,81,0.444,21,41,0.512,15,40,0.375,21,25,0.84,108
454,2021/2/22,PHO,POR,W 132-100,240,50,99,0.505,34,66,0.515,16,33,0.485,16,18,0.889,132,37,84,0.44,25,45,0.556,12,39,0.308,14,19,0.737,100
455,2021/2/22,POR,PHO,L 100-132,240,37,84,0.44,25,45,0.556,12,39,0.308,14,19,0.737,100,50,99,0.505,34,66,0.515,16,33,0.485,16,18,0.889,132
456,2021/2/22,CHO,UTA,L 110-132,240,41,89,0.461,30,53,0.566,11,36,0.306,17,21,0.81,110,45,85,0.529,17,30,0.567,28,55,0.509,14,17,0.824,132
457,2021/2/22,UTA,CHO,W 132-110,240,45,85,0.529,17,30,0.567,28,55,0.509,14,17,0.824,132,41,89,0.461,30,53,0.566,11,36,0.306,17,21,0.81,110
458,2021/2/21,ATL,DEN,W 123-115,240,42,81,0.519,30,47,0.638,12,34,0.353,27,33,0.818,123,43,84,0.512,27,48,0.563,16,36,0.444,13,16,0.813,115
459,2021/2/21,DEN,ATL,L 115-123,240,43,84,0.512,27,48,0.563,16,36,0.444,13,16,0.813,115,42,81,0.519,30,47,0.638,12,34,0.353,27,33,0.818,123
460,2021/2/21,CLE,OKC,L 101-117,240,39,84,0.464,31,49,0.633,8,35,0.229,15,20,0.75,101,43,79,0.544,30,51,0.588,13,28,0.464,18,24,0.75,117
461,2021/2/21,OKC,CLE,W 117-101,240,43,79,0.544,30,51,0.588,13,28,0.464,18,24,0.75,117,39,84,0.464,31,49,0.633,8,35,0.229,15,20,0.75,101
462,2021/2/21,BRK,LAC,W 112-108,240,44,92,0.478,33,54,0.611,11,38,0.289,13,19,0.684,112,40,87,0.46,25,52,0.481,15,35,0.429,13,18,0.722,108
463,2021/2/21,LAC,BRK,L 108-112,240,40,87,0.46,25,52,0.481,15,35,0.429,13,18,0.722,108,44,92,0.478,33,54,0.611,11,38,0.289,13,19,0.684,112
464,2021/2/21,MIL,SAC,W 128-115,240,44,90,0.489,33,62,0.532,11,28,0.393,29,36,0.806,128,44,100,0.44,32,67,0.478,12,33,0.364,15,20,0.75,115
465,2021/2/21,SAC,MIL,L 115-128,240,44,100,0.44,32,67,0.478,12,33,0.364,15,20,0.75,115,44,90,0.489,33,62,0.532,11,28,0.393,29,36,0.806,128
466,2021/2/21,BOS,NOP,L 115-120 (OT),265,39,98,0.398,29,61,0.475,10,37,0.27,27,34,0.794,115,42,94,0.447,31,58,0.534,11,36,0.306,25,37,0.676,120
467,2021/2/21,NOP,BOS,W 120-115 (OT),265,42,94,0.447,31,58,0.534,11,36,0.306,25,37,0.676,120,39,98,0.398,29,61,0.475,10,37,0.27,27,34,0.794,115
468,2021/2/21,MIN,NYK,L 99-103,240,33,82,0.402,17,47,0.362,16,35,0.457,17,21,0.81,99,33,78,0.423,27,60,0.45,6,18,0.333,31,38,0.816,103
469,2021/2/21,NYK,MIN,W 103-99,240,33,78,0.423,27,60,0.45,6,18,0.333,31,38,0.816,103,33,82,0.402,17,47,0.362,16,35,0.457,17,21,0.81,99
470,2021/2/21,DET,ORL,L 96-105,240,34,91,0.374,23,51,0.451,11,40,0.275,17,21,0.81,96,35,81,0.432,26,51,0.51,9,30,0.3,26,29,0.897,105
471,2021/2/21,ORL,DET,W 105-96,240,35,81,0.432,26,51,0.51,9,30,0.3,26,29,0.897,105,34,91,0.374,23,51,0.451,11,40,0.275,17,21,0.81,96
472,2021/2/21,PHI,TOR,L 103-110,240,33,85,0.388,22,48,0.458,11,37,0.297,26,35,0.743,103,40,81,0.494,26,47,0.553,14,34,0.412,16,18,0.889,110
473,2021/2/21,TOR,PHI,W 110-103,240,40,81,0.494,26,47,0.553,14,34,0.412,16,18,0.889,110,33,85,0.388,22,48,0.458,11,37,0.297,26,35,0.743,103
474,2021/2/20,CHI,SAC,W 122-114,240,49,82,0.598,38,59,0.644,11,23,0.478,13,15,0.867,122,44,98,0.449,36,69,0.522,8,29,0.276,18,22,0.818,114
475,2021/2/20,SAC,CHI,L 114-122,240,44,98,0.449,36,69,0.522,8,29,0.276,18,22,0.818,114,49,82,0.598,38,59,0.644,11,23,0.478,13,15,0.867,122
476,2021/2/20,CHO,GSW,W 102-100,240,37,75,0.493,17,35,0.486,20,40,0.5,8,9,0.889,102,37,85,0.435,24,46,0.522,13,39,0.333,13,17,0.765,100
477,2021/2/20,GSW,CHO,L 100-102,240,37,85,0.435,24,46,0.522,13,39,0.333,13,17,0.765,100,37,75,0.493,17,35,0.486,20,40,0.5,8,9,0.889,102
478,2021/2/20,LAL,MIA,L 94-96,240,33,84,0.393,20,39,0.513,13,45,0.289,15,17,0.882,94,36,85,0.424,28,57,0.491,8,28,0.286,16,23,0.696,96
479,2021/2/20,MIA,LAL,W 96-94,240,36,85,0.424,28,57,0.491,8,28,0.286,16,23,0.696,96,33,84,0.393,20,39,0.513,13,45,0.289,15,17,0.882,94
480,2021/2/20,MEM,PHO,L 97-128,240,36,93,0.387,31,60,0.517,5,33,0.152,20,23,0.87,97,46,86,0.535,22,40,0.55,24,46,0.522,12,13,0.923,128
481,2021/2/20,PHO,MEM,W 128-97,240,46,86,0.535,22,40,0.55,24,46,0.522,12,13,0.923,128,36,93,0.387,31,60,0.517,5,33,0.152,20,23,0.87,97
482,2021/2/20,POR,WAS,L 111-118,240,37,103,0.359,18,48,0.375,19,55,0.345,18,25,0.72,111,45,89,0.506,39,63,0.619,6,26,0.231,22,29,0.759,118
483,2021/2/20,WAS,POR,W 118-111,240,45,89,0.506,39,63,0.619,6,26,0.231,22,29,0.759,118,37,103,0.359,18,48,0.375,19,55,0.345,18,25,0.72,111
484,2021/2/19,ATL,BOS,L 109-121,240,38,90,0.422,28,60,0.467,10,30,0.333,23,25,0.92,109,50,90,0.556,36,55,0.655,14,35,0.4,7,10,0.7,121
485,2021/2/19,BOS,ATL,W 121-109,240,50,90,0.556,36,55,0.655,14,35,0.4,7,10,0.7,121,38,90,0.422,28,60,0.467,10,30,0.333,23,25,0.92,109
486,2021/2/19,CLE,DEN,L 103-120,240,39,83,0.47,27,52,0.519,12,31,0.387,13,21,0.619,103,46,80,0.575,31,49,0.633,15,31,0.484,13,17,0.765,120
487,2021/2/19,DEN,CLE,W 120-103,240,46,80,0.575,31,49,0.633,15,31,0.484,13,17,0.765,120,39,83,0.47,27,52,0.519,12,31,0.387,13,21,0.619,103
488,2021/2/19,LAC,UTA,W 116-112,240,43,89,0.483,33,59,0.559,10,30,0.333,20,22,0.909,116,41,86,0.477,29,52,0.558,12,34,0.353,18,21,0.857,112
489,2021/2/19,UTA,LAC,L 112-116,240,41,86,0.477,29,52,0.558,12,34,0.353,18,21,0.857,112,43,89,0.483,33,59,0.559,10,30,0.333,20,22,0.909,116
490,2021/2/19,DET,MEM,L 95-109,240,36,86,0.419,22,41,0.537,14,45,0.311,9,13,0.692,95,42,90,0.467,37,70,0.529,5,20,0.25,20,23,0.87,109
491,2021/2/19,MEM,DET,W 109-95,240,42,90,0.467,37,70,0.529,5,20,0.25,20,23,0.87,109,36,86,0.419,22,41,0.537,14,45,0.311,9,13,0.692,95
492,2021/2/19,MIL,OKC,W 98-85,240,35,86,0.407,24,52,0.462,11,34,0.324,17,25,0.68,98,31,85,0.365,19,45,0.422,12,40,0.3,11,21,0.524,85
493,2021/2/19,OKC,MIL,L 85-98,240,31,85,0.365,19,45,0.422,12,40,0.3,11,21,0.524,85,35,86,0.407,24,52,0.462,11,34,0.324,17,25,0.68,98
494,2021/2/19,MIN,TOR,L 81-86,240,32,83,0.386,23,45,0.511,9,38,0.237,8,11,0.727,81,28,85,0.329,16,45,0.356,12,40,0.3,18,22,0.818,86
495,2021/2/19,TOR,MIN,W 86-81,240,28,85,0.329,16,45,0.356,12,40,0.3,18,22,0.818,86,32,83,0.386,23,45,0.511,9,38,0.237,8,11,0.727,81
496,2021/2/19,NOP,PHO,L 114-132,240,42,82,0.512,31,50,0.62,11,32,0.344,19,24,0.792,114,51,88,0.58,29,49,0.592,22,39,0.564,8,12,0.667,132
497,2021/2/19,PHO,NOP,W 132-114,240,51,88,0.58,29,49,0.592,22,39,0.564,8,12,0.667,132,42,82,0.512,31,50,0.62,11,32,0.344,19,24,0.792,114
498,2021/2/19,GSW,ORL,L 120-124,240,46,97,0.474,27,55,0.491,19,42,0.452,9,15,0.6,120,46,94,0.489,28,51,0.549,18,43,0.419,14,17,0.824,124
499,2021/2/19,ORL,GSW,W 124-120,240,46,94,0.489,28,51,0.549,18,43,0.419,14,17,0.824,124,46,97,0.474,27,55,0.491,19,42,0.452,9,15,0.6,120
500,2021/2/19,CHI,PHI,L 105-112,240,40,95,0.421,33,63,0.524,7,32,0.219,18,18,1,105,41,87,0.471,34,66,0.515,7,21,0.333,23,29,0.793,112
501,2021/2/19,PHI,CHI,W 112-105,240,41,87,0.471,34,66,0.515,7,21,0.333,23,29,0.793,112,40,95,0.421,33,63,0.524,7,32,0.219,18,18,1,105
502,2021/2/18,BRK,LAL,W 109-98,240,38,77,0.494,20,38,0.526,18,39,0.462,15,24,0.625,109,40,83,0.482,32,53,0.604,8,30,0.267,10,14,0.714,98
503,2021/2/18,LAL,BRK,L 98-109,240,40,83,0.482,32,53,0.604,8,30,0.267,10,14,0.714,98,38,77,0.494,20,38,0.526,18,39,0.462,15,24,0.625,109
504,2021/2/18,MIL,TOR,L 96-110,240,35,88,0.398,25,54,0.463,10,34,0.294,16,23,0.696,96,38,78,0.487,26,43,0.605,12,35,0.343,22,23,0.957,110
505,2021/2/18,TOR,MIL,W 110-96,240,38,78,0.487,26,43,0.605,12,35,0.343,22,23,0.957,110,35,88,0.398,25,54,0.463,10,34,0.294,16,23,0.696,96
506,2021/2/18,MIA,SAC,W 118-110,240,49,95,0.516,37,61,0.607,12,34,0.353,8,10,0.8,118,43,93,0.462,28,52,0.538,15,41,0.366,9,16,0.563,110
507,2021/2/18,SAC,MIA,L 110-118,240,43,93,0.462,28,52,0.538,15,41,0.366,9,16,0.563,110,49,95,0.516,37,61,0.607,12,34,0.353,8,10,0.8,118
508,2021/2/17,ATL,BOS,W 122-114,240,44,77,0.571,36,53,0.679,8,24,0.333,26,31,0.839,122,40,86,0.465,30,55,0.545,10,31,0.323,24,27,0.889,114
509,2021/2/17,BOS,ATL,L 114-122,240,40,86,0.465,30,55,0.545,10,31,0.323,24,27,0.889,114,44,77,0.571,36,53,0.679,8,24,0.333,26,31,0.839,122
510,2021/2/17,CHI,DET,W 105-102,240,41,85,0.482,33,57,0.579,8,28,0.286,15,24,0.625,105,37,82,0.451,29,54,0.537,8,28,0.286,20,24,0.833,102
511,2021/2/17,DET,CHI,L 102-105,240,37,82,0.451,29,54,0.537,8,28,0.286,20,24,0.833,102,41,85,0.482,33,57,0.579,8,28,0.286,15,24,0.625,105
512,2021/2/17,GSW,MIA,W 120-112 (OT),265,43,95,0.453,25,43,0.581,18,52,0.346,16,21,0.762,120,44,97,0.454,31,61,0.508,13,36,0.361,11,12,0.917,112
513,2021/2/17,MIA,GSW,L 112-120 (OT),265,44,97,0.454,31,61,0.508,13,36,0.361,11,12,0.917,112,43,95,0.453,25,43,0.581,18,52,0.346,16,21,0.762,120
514,2021/2/17,LAC,UTA,L 96-114,240,38,86,0.442,29,60,0.483,9,26,0.346,11,17,0.647,96,42,98,0.429,29,58,0.5,13,40,0.325,17,20,0.85,114
515,2021/2/17,UTA,LAC,W 114-96,240,42,98,0.429,29,58,0.5,13,40,0.325,17,20,0.85,114,38,86,0.442,29,60,0.483,9,26,0.346,11,17,0.647,96
516,2021/2/17,MEM,OKC,W 122-113,240,42,83,0.506,30,57,0.526,12,26,0.462,26,33,0.788,122,35,78,0.449,16,37,0.432,19,41,0.463,24,28,0.857,113
517,2021/2/17,OKC,MEM,L 113-122,240,35,78,0.449,16,37,0.432,19,41,0.463,24,28,0.857,113,42,83,0.506,30,57,0.526,12,26,0.462,26,33,0.788,122
518,2021/2/17,IND,MIN,W 134-128 (OT),265,49,97,0.505,36,71,0.507,13,26,0.5,23,27,0.852,134,45,107,0.421,30,67,0.448,15,40,0.375,23,25,0.92,128
519,2021/2/17,MIN,IND,L 128-134 (OT),265,45,107,0.421,30,67,0.448,15,40,0.375,23,25,0.92,128,49,97,0.505,36,71,0.507,13,26,0.5,23,27,0.852,134
520,2021/2/17,NOP,POR,L 124-126,240,43,89,0.483,28,57,0.491,15,32,0.469,23,29,0.793,124,46,90,0.511,28,49,0.571,18,41,0.439,16,18,0.889,126
521,2021/2/17,POR,NOP,W 126-124,240,46,90,0.511,28,49,0.571,18,41,0.439,16,18,0.889,126,43,89,0.483,28,57,0.491,15,32,0.469,23,29,0.793,124
522,2021/2/17,NYK,ORL,L 89-107,240,33,87,0.379,26,60,0.433,7,27,0.259,16,19,0.842,89,42,92,0.457,26,58,0.448,16,34,0.471,7,10,0.7,107
523,2021/2/17,ORL,NYK,W 107-89,240,42,92,0.457,26,58,0.448,16,34,0.471,7,10,0.7,107,33,87,0.379,26,60,0.433,7,27,0.259,16,19,0.842,89
524,2021/2/17,HOU,PHI,L 113-118,240,42,92,0.457,27,45,0.6,15,47,0.319,14,18,0.778,113,39,81,0.481,27,55,0.491,12,26,0.462,28,32,0.875,118
525,2021/2/17,PHI,HOU,W 118-113,240,39,81,0.481,27,55,0.491,12,26,0.462,28,32,0.875,118,42,92,0.457,27,45,0.6,15,47,0.319,14,18,0.778,113
526,2021/2/17,DEN,WAS,L 128-130,240,48,92,0.522,31,54,0.574,17,38,0.447,15,18,0.833,128,44,86,0.512,29,53,0.547,15,33,0.455,27,34,0.794,130
527,2021/2/17,WAS,DEN,W 130-128,240,44,86,0.512,29,53,0.547,15,33,0.455,27,34,0.794,130,48,92,0.522,31,54,0.574,17,38,0.447,15,18,0.833,128
528,2021/2/16,BOS,DEN,W 112-99,240,39,81,0.481,24,39,0.615,15,42,0.357,19,21,0.905,112,38,84,0.452,29,50,0.58,9,34,0.265,14,15,0.933,99
529,2021/2/16,DEN,BOS,L 99-112,240,38,84,0.452,29,50,0.58,9,34,0.265,14,15,0.933,99,39,81,0.481,24,39,0.615,15,42,0.357,19,21,0.905,112
530,2021/2/16,MEM,NOP,L 113-144,240,42,88,0.477,29,57,0.509,13,31,0.419,16,18,0.889,113,56,91,0.615,37,53,0.698,19,38,0.5,13,17,0.765,144
531,2021/2/16,NOP,MEM,W 144-113,240,56,91,0.615,37,53,0.698,19,38,0.5,13,17,0.765,144,42,88,0.477,29,57,0.509,13,31,0.419,16,18,0.889,113
532,2021/2/16,MIL,TOR,L 113-124,240,40,83,0.482,26,46,0.565,14,37,0.378,19,25,0.76,113,46,91,0.505,29,48,0.604,17,43,0.395,15,21,0.714,124
533,2021/2/16,TOR,MIL,W 124-113,240,46,91,0.505,29,48,0.604,17,43,0.395,15,21,0.714,124,40,83,0.482,26,46,0.565,14,37,0.378,19,25,0.76,113
534,2021/2/16,LAL,MIN,W 112-104,240,42,77,0.545,31,51,0.608,11,26,0.423,17,21,0.81,112,39,93,0.419,23,59,0.39,16,34,0.471,10,13,0.769,104
535,2021/2/16,MIN,LAL,L 104-112,240,39,93,0.419,23,59,0.39,16,34,0.471,10,13,0.769,104,42,77,0.545,31,51,0.608,11,26,0.423,17,21,0.81,112
536,2021/2/16,OKC,POR,L 104-115,240,37,85,0.435,27,52,0.519,10,33,0.303,20,27,0.741,104,42,96,0.438,22,49,0.449,20,47,0.426,11,17,0.647,115
537,2021/2/16,POR,OKC,W 115-104,240,42,96,0.438,22,49,0.449,20,47,0.426,11,17,0.647,115,37,85,0.435,27,52,0.519,10,33,0.303,20,27,0.741,104
538,2021/2/16,BRK,PHO,W 128-124,240,47,82,0.573,27,42,0.643,20,40,0.5,14,15,0.933,128,48,88,0.545,32,51,0.627,16,37,0.432,12,12,1,124
539,2021/2/16,PHO,BRK,L 124-128,240,48,88,0.545,32,51,0.627,16,37,0.432,12,12,1,124,47,82,0.573,27,42,0.643,20,40,0.5,14,15,0.933,128
540,2021/2/15,CLE,GSW,L 98-129,240,37,95,0.389,29,65,0.446,8,30,0.267,16,20,0.8,98,46,88,0.523,29,51,0.569,17,37,0.459,20,21,0.952,129
541,2021/2/15,GSW,CLE,W 129-98,240,46,88,0.523,29,51,0.569,17,37,0.459,20,21,0.952,129,37,95,0.389,29,65,0.446,8,30,0.267,16,20,0.8,98
542,2021/2/15,CHI,IND,W 120-112 (OT),265,44,102,0.431,31,69,0.449,13,33,0.394,19,22,0.864,120,39,92,0.424,30,59,0.508,9,33,0.273,25,31,0.806,112
543,2021/2/15,IND,CHI,L 112-120 (OT),265,39,92,0.424,30,59,0.508,9,33,0.273,25,31,0.806,112,44,102,0.431,31,69,0.449,13,33,0.394,19,22,0.864,120
544,2021/2/15,LAC,MIA,W 125-118,240,47,85,0.553,32,53,0.604,15,32,0.469,16,20,0.8,125,46,91,0.505,38,55,0.691,8,36,0.222,18,22,0.818,118
545,2021/2/15,MIA,LAC,L 118-125,240,46,91,0.505,38,55,0.691,8,36,0.222,18,22,0.818,118,47,85,0.553,32,53,0.604,15,32,0.469,16,20,0.8,125
546,2021/2/15,ATL,NYK,L 112-123,240,36,85,0.424,25,52,0.481,11,33,0.333,29,32,0.906,112,42,83,0.506,25,49,0.51,17,34,0.5,22,27,0.815,123
547,2021/2/15,NYK,ATL,W 123-112,240,42,83,0.506,25,49,0.51,17,34,0.5,22,27,0.815,123,36,85,0.424,25,52,0.481,11,33,0.333,29,32,0.906,112
548,2021/2/15,BRK,SAC,W 136-125,240,51,89,0.573,24,42,0.571,27,47,0.574,7,12,0.583,136,51,96,0.531,39,63,0.619,12,33,0.364,11,13,0.846,125
549,2021/2/15,SAC,BRK,L 125-136,240,51,96,0.531,39,63,0.619,12,33,0.364,11,13,0.846,125,51,89,0.573,24,42,0.571,27,47,0.574,7,12,0.583,136
550,2021/2/15,PHI,UTA,L 123-134,240,47,94,0.5,39,71,0.549,8,23,0.348,21,24,0.875,123,45,86,0.523,27,41,0.659,18,45,0.4,26,31,0.839,134
551,2021/2/15,UTA,PHI,W 134-123,240,45,86,0.523,27,41,0.659,18,45,0.4,26,31,0.839,134,47,94,0.5,39,71,0.549,8,23,0.348,21,24,0.875,123
552,2021/2/15,HOU,WAS,L 119-131,240,43,91,0.473,35,54,0.648,8,37,0.216,25,34,0.735,119,48,92,0.522,36,62,0.581,12,30,0.4,23,31,0.742,131
553,2021/2/15,WAS,HOU,W 131-119,240,48,92,0.522,36,62,0.581,12,30,0.4,23,31,0.742,131,43,91,0.473,35,54,0.648,8,37,0.216,25,34,0.735,119
554,2021/2/14,CHO,SAS,L 110-122,240,45,95,0.474,33,61,0.541,12,34,0.353,8,11,0.727,110,48,96,0.5,38,62,0.613,10,34,0.294,16,19,0.842,122
555,2021/2/14,SAS,CHO,W 122-110,240,48,96,0.5,38,62,0.613,10,34,0.294,16,19,0.842,122,45,95,0.474,33,61,0.541,12,34,0.353,8,11,0.727,110
556,2021/2/14,DAL,POR,L 118-121,240,40,81,0.494,26,40,0.65,14,41,0.341,24,25,0.96,118,45,85,0.529,27,45,0.6,18,40,0.45,13,19,0.684,121
557,2021/2/14,POR,DAL,W 121-118,240,45,85,0.529,27,45,0.6,18,40,0.45,13,19,0.684,121,40,81,0.494,26,40,0.65,14,41,0.341,24,25,0.96,118
558,2021/2/14,DEN,LAL,W 122-105,240,39,85,0.459,20,38,0.526,19,47,0.404,25,34,0.735,122,40,87,0.46,34,59,0.576,6,28,0.214,19,29,0.655,105
559,2021/2/14,LAL,DEN,L 105-122,240,40,87,0.46,34,59,0.576,6,28,0.214,19,29,0.655,105,39,85,0.459,20,38,0.526,19,47,0.404,25,34,0.735,122
560,2021/2/14,DET,NOP,W 123-112,240,45,84,0.536,28,49,0.571,17,35,0.486,16,20,0.8,123,40,90,0.444,31,55,0.564,9,35,0.257,23,28,0.821,112
561,2021/2/14,NOP,DET,L 112-123,240,40,90,0.444,31,55,0.564,9,35,0.257,23,28,0.821,112,45,84,0.536,28,49,0.571,17,35,0.486,16,20,0.8,123
562,2021/2/14,CLE,LAC,L 111-128,240,43,93,0.462,36,68,0.529,7,25,0.28,18,25,0.72,111,42,88,0.477,29,58,0.5,13,30,0.433,31,36,0.861,128
563,2021/2/14,LAC,CLE,W 128-111,240,42,88,0.477,29,58,0.5,13,30,0.433,31,36,0.861,128,43,93,0.462,36,68,0.529,7,25,0.28,18,25,0.72,111
564,2021/2/14,MIL,OKC,L 109-114,240,45,97,0.464,32,59,0.542,13,38,0.342,6,9,0.667,109,45,95,0.474,30,59,0.508,15,36,0.417,9,16,0.563,114
565,2021/2/14,OKC,MIL,W 114-109,240,45,95,0.474,30,59,0.508,15,36,0.417,9,16,0.563,114,45,97,0.464,32,59,0.542,13,38,0.342,6,9,0.667,109
566,2021/2/14,ORL,PHO,L 90-109,240,33,89,0.371,27,54,0.5,6,35,0.171,18,22,0.818,90,41,92,0.446,29,55,0.527,12,37,0.324,15,16,0.938,109
567,2021/2/14,PHO,ORL,W 109-90,240,41,92,0.446,29,55,0.527,12,37,0.324,15,16,0.938,109,33,89,0.371,27,54,0.5,6,35,0.171,18,22,0.818,90
568,2021/2/14,MEM,SAC,W 124-110,240,50,94,0.532,41,73,0.562,9,21,0.429,15,19,0.789,124,41,82,0.5,33,49,0.673,8,33,0.242,20,26,0.769,110
569,2021/2/14,SAC,MEM,L 110-124,240,41,82,0.5,33,49,0.673,8,33,0.242,20,26,0.769,110,50,94,0.532,41,73,0.562,9,21,0.429,15,19,0.789,124
570,2021/2/14,MIN,TOR,W 116-112,240,43,82,0.524,27,43,0.628,16,39,0.41,14,19,0.737,116,38,91,0.418,28,58,0.483,10,33,0.303,26,31,0.839,112
571,2021/2/14,TOR,MIN,L 112-116,240,38,91,0.418,28,58,0.483,10,33,0.303,26,31,0.839,112,43,82,0.524,27,43,0.628,16,39,0.41,14,19,0.737,116
572,2021/2/14,BOS,WAS,L 91-104,240,32,90,0.356,23,55,0.418,9,35,0.257,18,30,0.6,91,33,83,0.398,26,53,0.491,7,30,0.233,31,36,0.861,104
573,2021/2/14,WAS,BOS,W 104-91,240,33,83,0.398,26,53,0.491,7,30,0.233,31,36,0.861,104,32,90,0.356,23,55,0.418,9,35,0.257,18,30,0.6,91
574,2021/2/13,ATL,IND,L 113-125,240,43,90,0.478,34,59,0.576,9,31,0.29,18,23,0.783,113,45,89,0.506,33,58,0.569,12,31,0.387,23,27,0.852,125
575,2021/2/13,IND,ATL,W 125-113,240,45,89,0.506,33,58,0.569,12,31,0.387,23,27,0.852,125,43,90,0.478,34,59,0.576,9,31,0.29,18,23,0.783,113
576,2021/2/13,BRK,GSW,W 134-117,240,50,93,0.538,34,54,0.63,16,39,0.41,18,20,0.9,134,44,90,0.489,35,56,0.625,9,34,0.265,20,25,0.8,117
577,2021/2/13,GSW,BRK,L 117-134,240,44,90,0.489,35,56,0.625,9,34,0.265,20,25,0.8,117,50,93,0.538,34,54,0.63,16,39,0.41,18,20,0.9,134
578,2021/2/13,HOU,NYK,L 99-121,240,33,88,0.375,25,45,0.556,8,43,0.186,25,30,0.833,99,45,86,0.523,33,58,0.569,12,28,0.429,19,23,0.826,121
579,2021/2/13,NYK,HOU,W 121-99,240,45,86,0.523,33,58,0.569,12,28,0.429,19,23,0.826,121,33,88,0.375,25,45,0.556,8,43,0.186,25,30,0.833,99
580,2021/2/13,PHI,PHO,L 111-120,240,38,73,0.521,31,56,0.554,7,17,0.412,28,33,0.848,111,48,79,0.608,38,54,0.704,10,25,0.4,14,17,0.824,120
581,2021/2/13,PHO,PHI,W 120-111,240,48,79,0.608,38,54,0.704,10,25,0.4,14,17,0.824,120,38,73,0.521,31,56,0.554,7,17,0.412,28,33,0.848,111
582,2021/2/13,MIA,UTA,L 94-112,240,35,86,0.407,23,50,0.46,12,36,0.333,12,17,0.706,94,39,85,0.459,27,39,0.692,12,46,0.261,22,29,0.759,112
583,2021/2/13,UTA,MIA,W 112-94,240,39,85,0.459,27,39,0.692,12,46,0.261,22,29,0.759,112,35,86,0.407,23,50,0.46,12,36,0.333,12,17,0.706,94
584,2021/2/12,ATL,SAS,L 114-125,240,39,90,0.433,28,58,0.483,11,32,0.344,25,33,0.758,114,45,85,0.529,33,54,0.611,12,31,0.387,23,28,0.821,125
585,2021/2/12,SAS,ATL,W 125-114,240,45,85,0.529,33,54,0.611,12,31,0.387,23,28,0.821,125,39,90,0.433,28,58,0.483,11,32,0.344,25,33,0.758,114
586,2021/2/12,BOS,DET,L 102-108,240,36,82,0.439,28,55,0.509,8,27,0.296,22,30,0.733,102,34,79,0.43,19,41,0.463,15,38,0.395,25,30,0.833,108
587,2021/2/12,DET,BOS,W 108-102,240,34,79,0.43,19,41,0.463,15,38,0.395,25,30,0.833,108,36,82,0.439,28,55,0.509,8,27,0.296,22,30,0.733,102
588,2021/2/12,CHI,LAC,L 106-125,240,40,85,0.471,28,53,0.528,12,32,0.375,14,15,0.933,106,50,86,0.581,37,56,0.661,13,30,0.433,12,15,0.8,125
589,2021/2/12,LAC,CHI,W 125-106,240,50,86,0.581,37,56,0.661,13,30,0.433,12,15,0.8,125,40,85,0.471,28,53,0.528,12,32,0.375,14,15,0.933,106
590,2021/2/12,CHO,MIN,W 120-114,240,44,90,0.489,31,54,0.574,13,36,0.361,19,19,1,120,45,99,0.455,29,58,0.5,16,41,0.39,8,14,0.571,114
591,2021/2/12,MIN,CHO,L 114-120,240,45,99,0.455,29,58,0.5,16,41,0.39,8,14,0.571,114,44,90,0.489,31,54,0.574,13,36,0.361,19,19,1,120
592,2021/2/12,DAL,NOP,W 143-130,240,51,88,0.58,26,43,0.605,25,45,0.556,16,21,0.762,143,48,90,0.533,31,53,0.585,17,37,0.459,17,23,0.739,130
593,2021/2/12,NOP,DAL,L 130-143,240,48,90,0.533,31,53,0.585,17,37,0.459,17,23,0.739,130,51,88,0.58,26,43,0.605,25,45,0.556,16,21,0.762,143
594,2021/2/12,DEN,OKC,W 97-95,240,40,87,0.46,30,47,0.638,10,40,0.25,7,10,0.7,97,36,90,0.4,26,58,0.448,10,32,0.313,13,17,0.765,95
595,2021/2/12,OKC,DEN,L 95-97,240,36,90,0.4,26,58,0.448,10,32,0.313,13,17,0.765,95,40,87,0.46,30,47,0.638,10,40,0.25,7,10,0.7,97
596,2021/2/12,LAL,MEM,W 115-105,240,43,85,0.506,37,55,0.673,6,30,0.2,23,33,0.697,115,39,80,0.488,27,51,0.529,12,29,0.414,15,19,0.789,105
597,2021/2/12,MEM,LAL,L 105-115,240,39,80,0.488,27,51,0.529,12,29,0.414,15,19,0.789,105,43,85,0.506,37,55,0.673,6,30,0.2,23,33,0.697,115
598,2021/2/12,CLE,POR,L 110-129,240,38,87,0.437,30,64,0.469,8,23,0.348,26,37,0.703,110,43,83,0.518,30,48,0.625,13,35,0.371,30,33,0.909,129
599,2021/2/12,POR,CLE,W 129-110,240,43,83,0.518,30,48,0.625,13,35,0.371,30,33,0.909,129,38,87,0.437,30,64,0.469,8,23,0.348,26,37,0.703,110
600,2021/2/12,ORL,SAC,W 123-112,240,46,91,0.505,31,57,0.544,15,34,0.441,16,20,0.8,123,43,83,0.518,31,50,0.62,12,33,0.364,14,19,0.737,112
601,2021/2/12,SAC,ORL,L 112-123,240,43,83,0.518,31,50,0.62,12,33,0.364,14,19,0.737,112,46,91,0.505,31,57,0.544,15,34,0.441,16,20,0.8,123
602,2021/2/12,MIL,UTA,L 115-129,240,42,92,0.457,30,59,0.508,12,33,0.364,19,27,0.704,115,43,82,0.524,29,44,0.659,14,38,0.368,29,34,0.853,129
603,2021/2/12,UTA,MIL,W 129-115,240,43,82,0.524,29,44,0.659,14,38,0.368,29,34,0.853,129,42,92,0.457,30,59,0.508,12,33,0.364,19,27,0.704,115
604,2021/2/12,NYK,WAS,W 109-91,240,44,98,0.449,38,74,0.514,6,24,0.25,15,22,0.682,109,34,89,0.382,25,55,0.455,9,34,0.265,14,20,0.7,91
605,2021/2/12,WAS,NYK,L 91-109,240,34,89,0.382,25,55,0.455,9,34,0.265,14,20,0.7,91,44,98,0.449,38,74,0.514,6,24,0.25,15,22,0.682,109
606,2021/2/11,BOS,TOR,W 120-106,240,39,86,0.453,19,47,0.404,20,39,0.513,22,28,0.786,120,41,83,0.494,32,55,0.582,9,28,0.321,15,19,0.789,106
607,2021/2/11,TOR,BOS,L 106-120,240,41,83,0.494,32,55,0.582,9,28,0.321,15,19,0.789,106,39,86,0.453,19,47,0.404,20,39,0.513,22,28,0.786,120
608,2021/2/11,DET,IND,L 95-111,240,38,85,0.447,33,57,0.579,5,28,0.179,14,19,0.737,95,44,86,0.512,30,55,0.545,14,31,0.452,9,10,0.9,111
609,2021/2/11,IND,DET,W 111-95,240,44,86,0.512,30,55,0.545,14,31,0.452,9,10,0.9,111,38,85,0.447,33,57,0.579,5,28,0.179,14,19,0.737,95
610,2021/2/11,GSW,ORL,W 111-105,240,41,88,0.466,21,38,0.553,20,50,0.4,9,12,0.75,111,38,97,0.392,23,64,0.359,15,33,0.455,14,18,0.778,105
611,2021/2/11,ORL,GSW,L 105-111,240,38,97,0.392,23,64,0.359,15,33,0.455,14,18,0.778,105,41,88,0.466,21,38,0.553,20,50,0.4,9,12,0.75,111
612,2021/2/11,HOU,MIA,L 94-101,240,32,83,0.386,17,33,0.515,15,50,0.3,15,20,0.75,94,34,79,0.43,19,37,0.514,15,42,0.357,18,20,0.9,101
613,2021/2/11,MIA,HOU,W 101-94,240,34,79,0.43,19,37,0.514,15,42,0.357,18,20,0.9,101,32,83,0.386,17,33,0.515,15,50,0.3,15,20,0.75,94
614,2021/2/11,PHI,POR,L 114-118,240,42,86,0.488,36,59,0.61,6,27,0.222,24,29,0.828,114,40,93,0.43,23,55,0.418,17,38,0.447,21,23,0.913,118
615,2021/2/11,POR,PHI,W 118-114,240,40,93,0.43,23,55,0.418,17,38,0.447,21,23,0.913,118,42,86,0.488,36,59,0.61,6,27,0.222,24,29,0.828,114
616,2021/2/10,BRK,IND,W 104-94,240,32,76,0.421,23,45,0.511,9,31,0.29,31,35,0.886,104,36,92,0.391,21,54,0.389,15,38,0.395,7,11,0.636,94
617,2021/2/10,IND,BRK,L 94-104,240,36,92,0.391,21,54,0.389,15,38,0.395,7,11,0.636,94,32,76,0.421,23,45,0.511,9,31,0.29,31,35,0.886,104
618,2021/2/10,CHI,NOP,W 129-116,240,48,81,0.593,23,34,0.676,25,47,0.532,8,11,0.727,129,41,81,0.506,28,45,0.622,13,36,0.361,21,26,0.808,116
619,2021/2/10,NOP,CHI,L 116-129,240,41,81,0.506,28,45,0.622,13,36,0.361,21,26,0.808,116,48,81,0.593,23,34,0.676,25,47,0.532,8,11,0.727,129
620,2021/2/10,ATL,DAL,L 117-118,240,40,88,0.455,26,49,0.531,14,39,0.359,23,28,0.821,117,43,84,0.512,29,49,0.592,14,35,0.4,18,20,0.9,118
621,2021/2/10,DAL,ATL,W 118-117,240,43,84,0.512,29,49,0.592,14,35,0.4,18,20,0.9,118,40,88,0.455,26,49,0.531,14,39,0.359,23,28,0.821,117
622,2021/2/10,CLE,DEN,L 95-133,240,36,94,0.383,28,57,0.491,8,37,0.216,15,20,0.75,95,51,85,0.6,35,49,0.714,16,36,0.444,15,21,0.714,133
623,2021/2/10,DEN,CLE,W 133-95,240,51,85,0.6,35,49,0.714,16,36,0.444,15,21,0.714,133,36,94,0.383,28,57,0.491,8,37,0.216,15,20,0.75,95
624,2021/2/10,LAL,OKC,W 114-113 (OT),265,42,89,0.472,32,54,0.593,10,35,0.286,20,24,0.833,114,47,100,0.47,40,69,0.58,7,31,0.226,12,14,0.857,113
625,2021/2/10,OKC,LAL,L 113-114 (OT),265,47,100,0.47,40,69,0.58,7,31,0.226,12,14,0.857,113,42,89,0.472,32,54,0.593,10,35,0.286,20,24,0.833,114
626,2021/2/10,CHO,MEM,L 114-130,240,45,82,0.549,31,53,0.585,14,29,0.483,10,12,0.833,114,47,94,0.5,24,45,0.533,23,49,0.469,13,18,0.722,130
627,2021/2/10,MEM,CHO,W 130-114,240,47,94,0.5,24,45,0.533,23,49,0.469,13,18,0.722,130,45,82,0.549,31,53,0.585,14,29,0.483,10,12,0.833,114
628,2021/2/10,LAC,MIN,W 119-112,240,41,82,0.5,29,59,0.492,12,23,0.522,25,29,0.862,119,41,95,0.432,26,54,0.481,15,41,0.366,15,19,0.789,112
629,2021/2/10,MIN,LAC,L 112-119,240,41,95,0.432,26,54,0.481,15,41,0.366,15,19,0.789,112,41,82,0.5,29,59,0.492,12,23,0.522,25,29,0.862,119
630,2021/2/10,MIL,PHO,L 124-125,240,43,85,0.506,27,48,0.563,16,37,0.432,22,30,0.733,124,46,87,0.529,31,56,0.554,15,31,0.484,18,25,0.72,125
631,2021/2/10,PHO,MIL,W 125-124,240,46,87,0.529,31,56,0.554,15,31,0.484,18,25,0.72,125,43,85,0.506,27,48,0.563,16,37,0.432,22,30,0.733,124
632,2021/2/10,TOR,WAS,W 137-115,240,49,93,0.527,30,61,0.492,19,32,0.594,20,23,0.87,137,42,93,0.452,30,52,0.577,12,41,0.293,19,23,0.826,115
633,2021/2/10,WAS,TOR,L 115-137,240,42,93,0.452,30,52,0.577,12,41,0.293,19,23,0.826,115,49,93,0.527,30,61,0.492,19,32,0.594,20,23,0.87,137
634,2021/2/9,BRK,DET,L 111-122,240,43,86,0.5,32,56,0.571,11,30,0.367,14,16,0.875,111,47,84,0.56,34,55,0.618,13,29,0.448,15,21,0.714,122
635,2021/2/9,DET,BRK,W 122-111,240,47,84,0.56,34,55,0.618,13,29,0.448,15,21,0.714,122,43,86,0.5,32,56,0.571,11,30,0.367,14,16,0.875,111
636,2021/2/9,MIA,NYK,W 98-96,240,26,70,0.371,12,37,0.324,14,33,0.424,32,39,0.821,98,37,87,0.425,27,59,0.458,10,28,0.357,12,16,0.75,96
637,2021/2/9,NYK,MIA,L 96-98,240,37,87,0.425,27,59,0.458,10,28,0.357,12,16,0.75,96,26,70,0.371,12,37,0.324,14,33,0.424,32,39,0.821,98
638,2021/2/9,HOU,NOP,L 101-130,240,38,91,0.418,25,48,0.521,13,43,0.302,12,21,0.571,101,47,92,0.511,35,61,0.574,12,31,0.387,24,28,0.857,130
639,2021/2/9,NOP,HOU,W 130-101,240,47,92,0.511,35,61,0.574,12,31,0.387,24,28,0.857,130,38,91,0.418,25,48,0.521,13,43,0.302,12,21,0.571,101
640,2021/2/9,ORL,POR,L 97-106,240,37,88,0.42,26,53,0.491,11,35,0.314,12,22,0.545,97,35,90,0.389,17,44,0.386,18,46,0.391,18,19,0.947,106
641,2021/2/9,POR,ORL,W 106-97,240,35,90,0.389,17,44,0.386,18,46,0.391,18,19,0.947,106,37,88,0.42,26,53,0.491,11,35,0.314,12,22,0.545,97
642,2021/2/9,PHI,SAC,W 119-111,240,41,85,0.482,32,65,0.492,9,20,0.45,28,35,0.8,119,43,99,0.434,29,57,0.509,14,42,0.333,11,19,0.579,111
643,2021/2/9,SAC,PHI,L 111-119,240,43,99,0.434,29,57,0.509,14,42,0.333,11,19,0.579,111,41,85,0.482,32,65,0.492,9,20,0.45,28,35,0.8,119
644,2021/2/9,GSW,SAS,W 114-91,240,42,91,0.462,25,51,0.49,17,40,0.425,13,19,0.684,114,32,86,0.372,24,62,0.387,8,24,0.333,19,21,0.905,91
645,2021/2/9,SAS,GSW,L 91-114,240,32,86,0.372,24,62,0.387,8,24,0.333,19,21,0.905,91,42,91,0.462,25,51,0.49,17,40,0.425,13,19,0.684,114
646,2021/2/9,BOS,UTA,L 108-122,240,38,86,0.442,25,57,0.439,13,29,0.448,19,23,0.826,108,40,84,0.476,22,36,0.611,18,48,0.375,24,27,0.889,122
647,2021/2/9,UTA,BOS,W 122-108,240,40,84,0.476,22,36,0.611,18,48,0.375,24,27,0.889,122,38,86,0.442,25,57,0.439,13,29,0.448,19,23,0.826,108
648,2021/2/8,CHI,WAS,L 101-105,240,36,85,0.424,27,55,0.491,9,30,0.3,20,24,0.833,101,36,86,0.419,30,60,0.5,6,26,0.231,27,36,0.75,105
649,2021/2/8,WAS,CHI,W 105-101,240,36,86,0.419,30,60,0.5,6,26,0.231,27,36,0.75,105,36,85,0.424,27,55,0.491,9,30,0.3,20,24,0.833,101
650,2021/2/8,CHO,HOU,W 119-94,240,44,90,0.489,25,49,0.51,19,41,0.463,12,13,0.923,119,35,86,0.407,22,39,0.564,13,47,0.277,11,16,0.688,94
651,2021/2/8,HOU,CHO,L 94-119,240,35,86,0.407,22,39,0.564,13,47,0.277,11,16,0.688,94,44,90,0.489,25,49,0.51,19,41,0.463,12,13,0.923,119
652,2021/2/8,DAL,MIN,W 127-122,240,45,87,0.517,33,53,0.623,12,34,0.353,25,30,0.833,127,42,91,0.462,24,49,0.49,18,42,0.429,20,28,0.714,122
653,2021/2/8,MIN,DAL,L 122-127,240,42,91,0.462,24,49,0.49,18,42,0.429,20,28,0.714,122,45,87,0.517,33,53,0.623,12,34,0.353,25,30,0.833,127
654,2021/2/8,DEN,MIL,L 112-125,240,41,94,0.436,26,58,0.448,15,36,0.417,15,16,0.938,112,45,89,0.506,29,49,0.592,16,40,0.4,19,22,0.864,125
655,2021/2/8,MIL,DEN,W 125-112,240,45,89,0.506,29,49,0.592,16,40,0.4,19,22,0.864,125,41,94,0.436,26,58,0.448,15,36,0.417,15,16,0.938,112
656,2021/2/8,LAL,OKC,W 119-112 (OT),265,44,95,0.463,35,57,0.614,9,38,0.237,22,29,0.759,119,43,110,0.391,31,72,0.431,12,38,0.316,14,19,0.737,112
657,2021/2/8,OKC,LAL,L 112-119 (OT),265,43,110,0.391,31,72,0.431,12,38,0.316,14,19,0.737,112,44,95,0.463,35,57,0.614,9,38,0.237,22,29,0.759,119
658,2021/2/8,MEM,TOR,L 113-128,240,37,87,0.425,24,48,0.5,13,39,0.333,26,29,0.897,113,42,77,0.545,22,40,0.55,20,37,0.541,24,26,0.923,128
659,2021/2/8,TOR,MEM,W 128-113,240,42,77,0.545,22,40,0.55,20,37,0.541,24,26,0.923,128,37,87,0.425,24,48,0.5,13,39,0.333,26,29,0.897,113
660,2021/2/8,CLE,PHO,L 113-119,240,44,86,0.512,36,62,0.581,8,24,0.333,17,25,0.68,113,47,90,0.522,36,66,0.545,11,24,0.458,14,19,0.737,119
661,2021/2/8,PHO,CLE,W 119-113,240,47,90,0.522,36,66,0.545,11,24,0.458,14,19,0.737,119,44,86,0.512,36,62,0.581,8,24,0.333,17,25,0.68,113
662,2021/2/8,GSW,SAS,L 100-105,240,38,86,0.442,25,49,0.51,13,37,0.351,11,15,0.733,100,39,96,0.406,28,65,0.431,11,31,0.355,16,19,0.842,105
663,2021/2/8,SAS,GSW,W 105-100,240,39,96,0.406,28,65,0.431,11,31,0.355,16,19,0.842,105,38,86,0.442,25,49,0.51,13,37,0.351,11,15,0.733,100
664,2021/2/7,CHO,WAS,W 119-97,240,42,99,0.424,27,63,0.429,15,36,0.417,20,26,0.769,119,34,90,0.378,25,50,0.5,9,40,0.225,20,28,0.714,97
665,2021/2/7,WAS,CHO,L 97-119,240,34,90,0.378,25,50,0.5,9,40,0.225,20,28,0.714,97,42,99,0.424,27,63,0.429,15,36,0.417,20,26,0.769,119
666,2021/2/7,IND,UTA,L 95-103,240,37,93,0.398,29,64,0.453,8,29,0.276,13,18,0.722,95,38,92,0.413,25,50,0.5,13,42,0.31,14,21,0.667,103
667,2021/2/7,UTA,IND,W 103-95,240,38,92,0.413,25,50,0.5,13,42,0.31,14,21,0.667,103,37,93,0.398,29,64,0.453,8,29,0.276,13,18,0.722,95
668,2021/2/7,LAC,SAC,L 110-113,240,41,99,0.414,33,71,0.465,8,28,0.286,20,23,0.87,110,46,94,0.489,36,65,0.554,10,29,0.345,11,15,0.733,113
669,2021/2/7,SAC,LAC,W 113-110,240,46,94,0.489,36,65,0.554,10,29,0.345,11,15,0.733,113,41,99,0.414,33,71,0.465,8,28,0.286,20,23,0.87,110
670,2021/2/7,MIA,NYK,W 109-103,240,40,83,0.482,27,48,0.563,13,35,0.371,16,20,0.8,109,38,85,0.447,22,43,0.512,16,42,0.381,11,15,0.733,103
671,2021/2/7,NYK,MIA,L 103-109,240,38,85,0.447,22,43,0.512,16,42,0.381,11,15,0.733,103,40,83,0.482,27,48,0.563,13,35,0.371,16,20,0.8,109
672,2021/2/7,BOS,PHO,L 91-100,240,33,93,0.355,16,49,0.327,17,44,0.386,8,12,0.667,91,40,82,0.488,32,53,0.604,8,29,0.276,12,12,1,100
673,2021/2/7,PHO,BOS,W 100-91,240,40,82,0.488,32,53,0.604,8,29,0.276,12,12,1,100,33,93,0.355,16,49,0.327,17,44,0.386,8,12,0.667,91
674,2021/2/6,ATL,TOR,W 132-121,240,42,74,0.568,23,38,0.605,19,36,0.528,29,33,0.879,132,41,97,0.423,28,59,0.475,13,38,0.342,26,34,0.765,121
675,2021/2/6,TOR,ATL,L 121-132,240,41,97,0.423,28,59,0.475,13,38,0.342,26,34,0.765,121,42,74,0.568,23,38,0.605,19,36,0.528,29,33,0.879,132
676,2021/2/6,CLE,MIL,L 99-124,240,39,86,0.453,33,58,0.569,6,28,0.214,15,21,0.714,99,47,86,0.547,31,52,0.596,16,34,0.471,14,23,0.609,124
677,2021/2/6,MIL,CLE,W 124-99,240,47,86,0.547,31,52,0.596,16,34,0.471,14,23,0.609,124,39,86,0.453,33,58,0.569,6,28,0.214,15,21,0.714,99
678,2021/2/6,DAL,GSW,W 134-132,240,44,96,0.458,23,49,0.469,21,47,0.447,25,30,0.833,134,46,86,0.535,26,41,0.634,20,45,0.444,20,23,0.87,132
679,2021/2/6,GSW,DAL,L 132-134,240,46,86,0.535,26,41,0.634,20,45,0.444,20,23,0.87,132,44,96,0.458,23,49,0.469,21,47,0.447,25,30,0.833,134
680,2021/2/6,HOU,SAS,L 106-111,240,38,88,0.432,26,50,0.52,12,38,0.316,18,25,0.72,106,37,87,0.425,29,62,0.468,8,25,0.32,29,36,0.806,111
681,2021/2/6,SAS,HOU,W 111-106,240,37,87,0.425,29,62,0.468,8,25,0.32,29,36,0.806,111,38,88,0.432,26,50,0.52,12,38,0.316,18,25,0.72,106
682,2021/2/6,DET,LAL,L 129-135 (2OT),290,45,94,0.479,29,52,0.558,16,42,0.381,23,28,0.821,129,51,91,0.56,42,72,0.583,9,19,0.474,24,28,0.857,135
683,2021/2/6,LAL,DET,W 135-129 (2OT),290,51,91,0.56,42,72,0.583,9,19,0.474,24,28,0.857,135,45,94,0.479,29,52,0.558,16,42,0.381,23,28,0.821,129
684,2021/2/6,MEM,NOP,L 109-118,240,40,90,0.444,27,51,0.529,13,39,0.333,16,19,0.842,109,45,87,0.517,30,54,0.556,15,33,0.455,13,21,0.619,118
685,2021/2/6,NOP,MEM,W 118-109,240,45,87,0.517,30,54,0.556,15,33,0.455,13,21,0.619,118,40,90,0.444,27,51,0.529,13,39,0.333,16,19,0.842,109
686,2021/2/6,NYK,POR,W 110-99,240,44,88,0.5,31,58,0.534,13,30,0.433,9,13,0.692,110,37,89,0.416,20,42,0.476,17,47,0.362,8,16,0.5,99
687,2021/2/6,POR,NYK,L 99-110,240,37,89,0.416,20,42,0.476,17,47,0.362,8,16,0.5,99,44,88,0.5,31,58,0.534,13,30,0.433,9,13,0.692,110
688,2021/2/6,MIN,OKC,L 118-120,240,47,93,0.505,35,57,0.614,12,36,0.333,12,22,0.545,118,46,90,0.511,34,57,0.596,12,33,0.364,16,20,0.8,120
689,2021/2/6,OKC,MIN,W 120-118,240,46,90,0.511,34,57,0.596,12,33,0.364,16,20,0.8,120,47,93,0.505,35,57,0.614,12,36,0.333,12,22,0.545,118
690,2021/2/6,CHI,ORL,W 118-92,240,47,91,0.516,32,61,0.525,15,30,0.5,9,13,0.692,118,37,95,0.389,31,68,0.456,6,27,0.222,12,12,1,92
691,2021/2/6,ORL,CHI,L 92-118,240,37,95,0.389,31,68,0.456,6,27,0.222,12,12,1,92,47,91,0.516,32,61,0.525,15,30,0.5,9,13,0.692,118
692,2021/2/6,BRK,PHI,L 108-124,240,39,88,0.443,24,47,0.511,15,41,0.366,15,17,0.882,108,48,94,0.511,38,67,0.567,10,27,0.37,18,22,0.818,124
693,2021/2/6,PHI,BRK,W 124-108,240,48,94,0.511,38,67,0.567,10,27,0.37,18,22,0.818,124,39,88,0.443,24,47,0.511,15,41,0.366,15,17,0.882,108
694,2021/2/6,DEN,SAC,L 114-119,240,45,97,0.464,32,62,0.516,13,35,0.371,11,14,0.786,114,44,91,0.484,30,56,0.536,14,35,0.4,17,24,0.708,119
695,2021/2/6,SAC,DEN,W 119-114,240,44,91,0.484,30,56,0.536,14,35,0.4,17,24,0.708,119,45,97,0.464,32,62,0.516,13,35,0.371,11,14,0.786,114
696,2021/2/5,BRK,TOR,L 117-123,240,39,80,0.488,22,38,0.579,17,42,0.405,22,29,0.759,117,49,97,0.505,36,65,0.554,13,32,0.406,12,14,0.857,123
697,2021/2/5,TOR,BRK,W 123-117,240,49,97,0.505,36,65,0.554,13,32,0.406,12,14,0.857,123,39,80,0.488,22,38,0.579,17,42,0.405,22,29,0.759,117
698,2021/2/5,CHO,UTA,L 121-138,240,48,104,0.462,37,69,0.536,11,35,0.314,14,17,0.824,121,48,87,0.552,22,37,0.595,26,50,0.52,16,18,0.889,138
699,2021/2/5,UTA,CHO,W 138-121,240,48,87,0.552,22,37,0.595,26,50,0.52,16,18,0.889,138,48,104,0.462,37,69,0.536,11,35,0.314,14,17,0.824,121
700,2021/2/5,CLE,MIL,L 105-123,240,41,92,0.446,30,60,0.5,11,32,0.344,12,16,0.75,105,50,97,0.515,43,75,0.573,7,22,0.318,16,22,0.727,123
701,2021/2/5,MIL,CLE,W 123-105,240,50,97,0.515,43,75,0.573,7,22,0.318,16,22,0.727,123,41,92,0.446,30,60,0.5,11,32,0.344,12,16,0.75,105
702,2021/2/5,IND,NOP,L 113-114,240,41,93,0.441,21,51,0.412,20,42,0.476,11,16,0.688,113,41,76,0.539,28,51,0.549,13,25,0.52,19,26,0.731,114
703,2021/2/5,NOP,IND,W 114-113,240,41,76,0.539,28,51,0.549,13,25,0.52,19,26,0.731,114,41,93,0.441,21,51,0.412,20,42,0.476,11,16,0.688,113
704,2021/2/5,BOS,LAC,W 119-115,240,43,90,0.478,27,52,0.519,16,38,0.421,17,21,0.81,119,42,81,0.519,28,49,0.571,14,32,0.438,17,21,0.81,115
705,2021/2/5,LAC,BOS,L 115-119,240,42,81,0.519,28,49,0.571,14,32,0.438,17,21,0.81,115,43,90,0.478,27,52,0.519,16,38,0.421,17,21,0.81,119
706,2021/2/5,MIA,WAS,W 122-95,240,43,86,0.5,27,50,0.54,16,36,0.444,20,23,0.87,122,33,89,0.371,25,56,0.446,8,33,0.242,21,24,0.875,95
707,2021/2/5,WAS,MIA,L 95-122,240,33,89,0.371,25,56,0.446,8,33,0.242,21,24,0.875,95,43,86,0.5,27,50,0.54,16,36,0.444,20,23,0.87,122
708,2021/2/5,MIN,OKC,W 106-103,240,41,94,0.436,25,54,0.463,16,40,0.4,8,9,0.889,106,39,85,0.459,26,51,0.51,13,34,0.382,12,17,0.706,103
709,2021/2/5,OKC,MIN,L 103-106,240,39,85,0.459,26,51,0.51,13,34,0.382,12,17,0.706,103,41,94,0.436,25,54,0.463,16,40,0.4,8,9,0.889,106
710,2021/2/5,CHI,ORL,L 119-123,240,46,96,0.479,37,66,0.561,9,30,0.3,18,20,0.9,119,42,81,0.519,31,54,0.574,11,27,0.407,28,37,0.757,123
711,2021/2/5,ORL,CHI,W 123-119,240,42,81,0.519,31,54,0.574,11,27,0.407,28,37,0.757,123,46,96,0.479,37,66,0.561,9,30,0.3,18,20,0.9,119
712,2021/2/5,DET,PHO,L 92-109,240,34,91,0.374,27,55,0.491,7,36,0.194,17,28,0.607,92,42,85,0.494,30,53,0.566,12,32,0.375,13,16,0.813,109
713,2021/2/5,PHO,DET,W 109-92,240,42,85,0.494,30,53,0.566,12,32,0.375,13,16,0.813,109,34,91,0.374,27,55,0.491,7,36,0.194,17,28,0.607,92
714,2021/2/4,ATL,UTA,L 91-112,240,32,98,0.327,23,67,0.343,9,31,0.29,18,19,0.947,91,44,91,0.484,31,64,0.484,13,27,0.481,11,13,0.846,112
715,2021/2/4,UTA,ATL,W 112-91,240,44,91,0.484,31,64,0.484,13,27,0.481,11,13,0.846,112,32,98,0.327,23,67,0.343,9,31,0.29,18,19,0.947,91
716,2021/2/4,DAL,GSW,L 116-147,240,38,92,0.413,18,42,0.429,20,50,0.4,20,23,0.87,116,51,89,0.573,29,46,0.63,22,43,0.512,23,27,0.852,147
717,2021/2/4,GSW,DAL,W 147-116,240,51,89,0.573,29,46,0.63,22,43,0.512,23,27,0.852,147,38,92,0.413,18,42,0.429,20,50,0.4,20,23,0.87,116
718,2021/2/4,DEN,LAL,L 93-114,240,36,92,0.391,28,64,0.438,8,28,0.286,13,15,0.867,93,46,81,0.568,38,57,0.667,8,24,0.333,14,22,0.636,114
719,2021/2/4,LAL,DEN,W 114-93,240,46,81,0.568,38,57,0.667,8,24,0.333,14,22,0.636,114,36,92,0.391,28,64,0.438,8,28,0.286,13,15,0.867,93
720,2021/2/4,HOU,MEM,W 115-103,240,41,87,0.471,22,42,0.524,19,45,0.422,14,17,0.824,115,37,87,0.425,25,52,0.481,12,35,0.343,17,24,0.708,103
721,2021/2/4,MEM,HOU,L 103-115,240,37,87,0.425,25,52,0.481,12,35,0.343,17,24,0.708,103,41,87,0.471,22,42,0.524,19,45,0.422,14,17,0.824,115
722,2021/2/4,PHI,POR,L 105-121,240,39,81,0.481,32,54,0.593,7,27,0.259,20,24,0.833,105,45,98,0.459,32,67,0.478,13,31,0.419,18,23,0.783,121
723,2021/2/4,POR,PHI,W 121-105,240,45,98,0.459,32,67,0.478,13,31,0.419,18,23,0.783,121,39,81,0.481,32,54,0.593,7,27,0.259,20,24,0.833,105
724,2021/2/3,ATL,DAL,L 116-122,240,45,90,0.5,31,52,0.596,14,38,0.368,12,17,0.706,116,43,93,0.462,30,53,0.566,13,40,0.325,23,25,0.92,122
725,2021/2/3,DAL,ATL,W 122-116,240,43,93,0.462,30,53,0.566,13,40,0.325,23,25,0.92,122,45,90,0.5,31,52,0.596,14,38,0.368,12,17,0.706,116
726,2021/2/3,CHI,NYK,L 103-107,240,43,88,0.489,37,52,0.712,6,36,0.167,11,16,0.688,103,43,89,0.483,32,67,0.478,11,22,0.5,10,15,0.667,107
727,2021/2/3,NYK,CHI,W 107-103,240,43,89,0.483,32,67,0.478,11,22,0.5,10,15,0.667,107,43,88,0.489,37,52,0.712,6,36,0.167,11,16,0.688,103
728,2021/2/3,CHO,PHI,L 111-118,240,39,87,0.448,25,50,0.5,14,37,0.378,19,23,0.826,111,41,79,0.519,31,55,0.564,10,24,0.417,26,32,0.813,118
729,2021/2/3,PHI,CHO,W 118-111,240,41,79,0.519,31,55,0.564,10,24,0.417,26,32,0.813,118,39,87,0.448,25,50,0.5,14,37,0.378,19,23,0.826,111
730,2021/2/3,CLE,LAC,L 99-121,240,41,92,0.446,37,82,0.451,4,10,0.4,13,17,0.765,99,44,79,0.557,24,45,0.533,20,34,0.588,13,17,0.765,121
731,2021/2/3,LAC,CLE,W 121-99,240,44,79,0.557,24,45,0.533,20,34,0.588,13,17,0.765,121,41,92,0.446,37,82,0.451,4,10,0.4,13,17,0.765,99
732,2021/2/3,MIA,WAS,L 100-103,240,36,83,0.434,24,48,0.5,12,35,0.343,16,22,0.727,100,35,84,0.417,20,47,0.426,15,37,0.405,18,25,0.72,103
733,2021/2/3,WAS,MIA,W 103-100,240,35,84,0.417,20,47,0.426,15,37,0.405,18,25,0.72,103,36,83,0.434,24,48,0.5,12,35,0.343,16,22,0.727,100
734,2021/2/3,IND,MIL,L 110-130,240,43,95,0.453,32,61,0.525,11,34,0.324,13,15,0.867,110,48,102,0.471,27,54,0.5,21,48,0.438,13,14,0.929,130
735,2021/2/3,MIL,IND,W 130-110,240,48,102,0.471,27,54,0.5,21,48,0.438,13,14,0.929,130,43,95,0.453,32,61,0.525,11,34,0.324,13,15,0.867,110
736,2021/2/3,NOP,PHO,W 123-101,240,46,90,0.511,32,57,0.561,14,33,0.424,17,21,0.81,123,38,82,0.463,30,47,0.638,8,35,0.229,17,20,0.85,101
737,2021/2/3,PHO,NOP,L 101-123,240,38,82,0.463,30,47,0.638,8,35,0.229,17,20,0.85,101,46,90,0.511,32,57,0.561,14,33,0.424,17,21,0.81,123
738,2021/2/3,HOU,OKC,L 87-104,240,33,86,0.384,21,40,0.525,12,46,0.261,9,13,0.692,87,36,83,0.434,26,50,0.52,10,33,0.303,22,26,0.846,104
739,2021/2/3,OKC,HOU,W 104-87,240,36,83,0.434,26,50,0.52,10,33,0.303,22,26,0.846,104,33,86,0.384,21,40,0.525,12,46,0.261,9,13,0.692,87
740,2021/2/3,BOS,SAC,L 111-116,240,39,86,0.453,28,53,0.528,11,33,0.333,22,29,0.759,111,42,92,0.457,29,55,0.527,13,37,0.351,19,23,0.826,116
741,2021/2/3,SAC,BOS,W 116-111,240,42,92,0.457,29,55,0.527,13,37,0.351,19,23,0.826,116,39,86,0.453,28,53,0.528,11,33,0.333,22,29,0.759,111
742,2021/2/3,MIN,SAS,L 108-111,240,43,94,0.457,30,61,0.492,13,33,0.394,9,11,0.818,108,43,96,0.448,36,70,0.514,7,26,0.269,18,24,0.75,111
743,2021/2/3,SAS,MIN,W 111-108,240,43,96,0.448,36,70,0.514,7,26,0.269,18,24,0.75,111,43,94,0.457,30,61,0.492,13,33,0.394,9,11,0.818,108
744,2021/2/2,BRK,LAC,W 124-120,240,45,79,0.57,32,48,0.667,13,31,0.419,21,26,0.808,124,45,99,0.455,30,63,0.476,15,36,0.417,15,17,0.882,120
745,2021/2/2,LAC,BRK,L 120-124,240,45,99,0.455,30,63,0.476,15,36,0.417,15,17,0.882,120,45,79,0.57,32,48,0.667,13,31,0.419,21,26,0.808,124
746,2021/2/2,BOS,GSW,W 111-107,240,39,84,0.464,26,50,0.52,13,34,0.382,20,27,0.741,111,38,83,0.458,23,46,0.5,15,37,0.405,16,23,0.696,107
747,2021/2/2,GSW,BOS,L 107-111,240,38,83,0.458,23,46,0.5,15,37,0.405,16,23,0.696,107,39,84,0.464,26,50,0.52,13,34,0.382,20,27,0.741,111
748,2021/2/2,IND,MEM,W 134-116,240,49,82,0.598,33,53,0.623,16,29,0.552,20,29,0.69,134,42,93,0.452,33,68,0.485,9,25,0.36,23,24,0.958,116
749,2021/2/2,MEM,IND,L 116-134,240,42,93,0.452,33,68,0.485,9,25,0.36,23,24,0.958,116,49,82,0.598,33,53,0.623,16,29,0.552,20,29,0.69,134
750,2021/2/2,ORL,TOR,L 108-123,240,41,89,0.461,27,51,0.529,14,38,0.368,12,14,0.857,108,40,83,0.482,20,38,0.526,20,45,0.444,23,25,0.92,123
751,2021/2/2,TOR,ORL,W 123-108,240,40,83,0.482,20,38,0.526,20,45,0.444,23,25,0.92,123,41,89,0.461,27,51,0.529,14,38,0.368,12,14,0.857,108
752,2021/2/2,DET,UTA,L 105-117,240,39,93,0.419,30,66,0.455,9,27,0.333,18,20,0.9,105,38,82,0.463,22,40,0.55,16,42,0.381,25,29,0.862,117
753,2021/2/2,UTA,DET,W 117-105,240,38,82,0.463,22,40,0.55,16,42,0.381,25,29,0.862,117,39,93,0.419,30,66,0.455,9,27,0.333,18,20,0.9,105
754,2021/2/2,POR,WAS,W 132-121,240,44,95,0.463,23,49,0.469,21,46,0.457,23,23,1,132,46,83,0.554,30,43,0.698,16,40,0.4,13,17,0.765,121
755,2021/2/2,WAS,POR,L 121-132,240,46,83,0.554,30,43,0.698,16,40,0.4,13,17,0.765,121,44,95,0.463,23,49,0.469,21,46,0.457,23,23,1,132
756,2021/2/1,ATL,LAL,L 99-107,240,37,78,0.474,26,49,0.531,11,29,0.379,14,17,0.824,99,40,77,0.519,33,54,0.611,7,23,0.304,20,24,0.833,107
757,2021/2/1,LAL,ATL,W 107-99,240,40,77,0.519,33,54,0.611,7,23,0.304,20,24,0.833,107,37,78,0.474,26,49,0.531,11,29,0.379,14,17,0.824,99
758,2021/2/1,CHI,NYK,W 110-102,240,42,88,0.477,31,54,0.574,11,34,0.324,15,20,0.75,110,37,87,0.425,31,58,0.534,6,29,0.207,22,26,0.846,102
759,2021/2/1,NYK,CHI,L 102-110,240,37,87,0.425,31,58,0.534,6,29,0.207,22,26,0.846,102,42,88,0.477,31,54,0.574,11,34,0.324,15,20,0.75,110
760,2021/2/1,CLE,MIN,W 100-98,240,35,84,0.417,28,62,0.452,7,22,0.318,23,31,0.742,100,40,102,0.392,29,64,0.453,11,38,0.289,7,11,0.636,98
761,2021/2/1,MIN,CLE,L 98-100,240,40,102,0.392,29,64,0.453,11,38,0.289,7,11,0.636,98,35,84,0.417,28,62,0.452,7,22,0.318,23,31,0.742,100
762,2021/2/1,DAL,PHO,L 108-109,240,37,86,0.43,27,54,0.5,10,32,0.313,24,25,0.96,108,43,92,0.467,30,57,0.526,13,35,0.371,10,12,0.833,109
763,2021/2/1,PHO,DAL,W 109-108,240,43,92,0.467,30,57,0.526,13,35,0.371,10,12,0.833,109,37,86,0.43,27,54,0.5,10,32,0.313,24,25,0.96,108
764,2021/2/1,CHO,MIA,W 129-121 (OT),265,43,95,0.453,22,54,0.407,21,41,0.512,22,26,0.846,129,43,91,0.473,24,45,0.533,19,46,0.413,16,25,0.64,121
765,2021/2/1,MIA,CHO,L 121-129 (OT),265,43,91,0.473,24,45,0.533,19,46,0.413,16,25,0.64,121,43,95,0.453,22,54,0.407,21,41,0.512,22,26,0.846,129
766,2021/2/1,MIL,POR,W 134-106,240,53,96,0.552,32,54,0.593,21,42,0.5,7,12,0.583,134,39,104,0.375,24,62,0.387,15,42,0.357,13,13,1,106
767,2021/2/1,POR,MIL,L 106-134,240,39,104,0.375,24,62,0.387,15,42,0.357,13,13,1,106,53,96,0.552,32,54,0.593,21,42,0.5,7,12,0.583,134
768,2021/2/1,NOP,SAC,L 109-118,240,40,101,0.396,31,71,0.437,9,30,0.3,20,24,0.833,109,42,88,0.477,28,45,0.622,14,43,0.326,20,26,0.769,118
769,2021/2/1,SAC,NOP,W 118-109,240,42,88,0.477,28,45,0.622,14,43,0.326,20,26,0.769,118,40,101,0.396,31,71,0.437,9,30,0.3,20,24,0.833,109
770,2021/2/1,HOU,OKC,W 136-106,240,49,102,0.48,21,50,0.42,28,52,0.538,10,11,0.909,136,39,89,0.438,26,55,0.473,13,34,0.382,15,19,0.789,106
771,2021/2/1,OKC,HOU,L 106-136,240,39,89,0.438,26,55,0.473,13,34,0.382,15,19,0.789,106,49,102,0.48,21,50,0.42,28,52,0.538,10,11,0.909,136
772,2021/2/1,MEM,SAS,W 133-102,240,52,93,0.559,37,63,0.587,15,30,0.5,14,18,0.778,133,37,89,0.416,24,52,0.462,13,37,0.351,15,22,0.682,102
773,2021/2/1,SAS,MEM,L 102-133,240,37,89,0.416,24,52,0.462,13,37,0.351,15,22,0.682,102,52,93,0.559,37,63,0.587,15,30,0.5,14,18,0.778,133
774,2021/1/31,DEN,UTA,W 128-117,240,47,87,0.54,29,59,0.492,18,28,0.643,16,19,0.842,128,32,75,0.427,12,28,0.429,20,47,0.426,33,39,0.846,117
775,2021/1/31,UTA,DEN,L 117-128,240,32,75,0.427,12,28,0.429,20,47,0.426,33,39,0.846,117,47,87,0.54,29,59,0.492,18,28,0.643,16,19,0.842,128
776,2021/1/31,IND,PHI,L 110-119,240,41,84,0.488,31,56,0.554,10,28,0.357,18,22,0.818,110,45,92,0.489,37,66,0.561,8,26,0.308,21,31,0.677,119
777,2021/1/31,PHI,IND,W 119-110,240,45,92,0.489,37,66,0.561,8,26,0.308,21,31,0.677,119,41,84,0.488,31,56,0.554,10,28,0.357,18,22,0.818,110
778,2021/1/31,CLE,MIN,L 104-109,240,41,84,0.488,37,68,0.544,4,16,0.25,18,23,0.783,104,41,91,0.451,25,51,0.49,16,40,0.4,11,15,0.733,109
779,2021/1/31,MIN,CLE,W 109-104,240,41,91,0.451,25,51,0.49,16,40,0.4,11,15,0.733,109,41,84,0.488,37,68,0.544,4,16,0.25,18,23,0.783,104
780,2021/1/31,LAC,NYK,W 129-115,240,44,81,0.543,27,43,0.628,17,38,0.447,24,28,0.857,129,41,85,0.482,31,58,0.534,10,27,0.37,23,28,0.821,115
781,2021/1/31,NYK,LAC,L 115-129,240,41,85,0.482,31,58,0.534,10,27,0.37,23,28,0.821,115,44,81,0.543,27,43,0.628,17,38,0.447,24,28,0.857,129
782,2021/1/31,ORL,TOR,L 102-115,240,33,82,0.402,20,46,0.435,13,36,0.361,23,28,0.821,102,41,90,0.456,29,51,0.569,12,39,0.308,21,22,0.955,115
783,2021/1/31,TOR,ORL,W 115-102,240,41,90,0.456,29,51,0.569,12,39,0.308,21,22,0.955,115,33,82,0.402,20,46,0.435,13,36,0.361,23,28,0.821,102
784,2021/1/31,BRK,WAS,L 146-149,240,50,88,0.568,31,52,0.596,19,36,0.528,27,33,0.818,146,56,108,0.519,44,69,0.638,12,39,0.308,25,32,0.781,149
785,2021/1/31,WAS,BRK,W 149-146,240,56,108,0.519,44,69,0.638,12,39,0.308,25,32,0.781,149,50,88,0.568,31,52,0.596,19,36,0.528,27,33,0.818,146
786,2021/1/30,BOS,LAL,L 95-96,240,40,82,0.488,34,61,0.557,6,21,0.286,9,14,0.643,95,37,84,0.44,28,53,0.528,9,31,0.29,13,19,0.684,96
787,2021/1/30,LAL,BOS,W 96-95,240,37,84,0.44,28,53,0.528,9,31,0.29,13,19,0.684,96,40,82,0.488,34,61,0.557,6,21,0.286,9,14,0.643,95
788,2021/1/30,CHI,POR,L 122-123,240,43,85,0.506,22,40,0.55,21,45,0.467,15,15,1,122,45,88,0.511,28,46,0.609,17,42,0.405,16,19,0.842,123
789,2021/1/30,POR,CHI,W 123-122,240,45,88,0.511,28,46,0.609,17,42,0.405,16,19,0.842,123,43,85,0.506,22,40,0.55,21,45,0.467,15,15,1,122
790,2021/1/30,CHO,MIL,W 126-114,240,44,92,0.478,23,48,0.479,21,44,0.477,17,20,0.85,126,40,82,0.488,22,37,0.595,18,45,0.4,16,24,0.667,114
791,2021/1/30,MIL,CHO,L 114-126,240,40,82,0.488,22,37,0.595,18,45,0.4,16,24,0.667,114,44,92,0.478,23,48,0.479,21,44,0.477,17,20,0.85,126
792,2021/1/30,DAL,PHO,L 105-111,240,44,83,0.53,35,54,0.648,9,29,0.31,8,14,0.571,105,37,81,0.457,27,59,0.458,10,22,0.455,27,31,0.871,111
793,2021/1/30,PHO,DAL,W 111-105,240,37,81,0.457,27,59,0.458,10,22,0.455,27,31,0.871,111,44,83,0.53,35,54,0.648,9,29,0.31,8,14,0.571,105
794,2021/1/30,DET,GSW,L 91-118,240,29,77,0.377,20,41,0.488,9,36,0.25,24,32,0.75,91,47,89,0.528,30,53,0.566,17,36,0.472,7,10,0.7,118
795,2021/1/30,GSW,DET,W 118-91,240,47,89,0.528,30,53,0.566,17,36,0.472,7,10,0.7,118,29,77,0.377,20,41,0.488,9,36,0.25,24,32,0.75,91
796,2021/1/30,MIA,SAC,W 105-104,240,36,77,0.468,25,45,0.556,11,32,0.344,22,26,0.846,105,41,85,0.482,24,40,0.6,17,45,0.378,5,11,0.455,104
797,2021/1/30,SAC,MIA,L 104-105,240,41,85,0.482,24,40,0.6,17,45,0.378,5,11,0.455,104,36,77,0.468,25,45,0.556,11,32,0.344,22,26,0.846,105
798,2021/1/30,HOU,NOP,W 126-112,240,45,92,0.489,25,46,0.543,20,46,0.435,16,20,0.8,126,41,91,0.451,29,50,0.58,12,41,0.293,18,29,0.621,112
799,2021/1/30,NOP,HOU,L 112-126,240,41,91,0.451,29,50,0.58,12,41,0.293,18,29,0.621,112,45,92,0.489,25,46,0.543,20,46,0.435,16,20,0.8,126
800,2021/1/30,MEM,SAS,W 129-112,240,51,91,0.56,34,56,0.607,17,35,0.486,10,15,0.667,129,39,83,0.47,26,54,0.481,13,29,0.448,21,26,0.808,112
801,2021/1/30,SAS,MEM,L 112-129,240,39,83,0.47,26,54,0.481,13,29,0.448,21,26,0.808,112,51,91,0.56,34,56,0.607,17,35,0.486,10,15,0.667,129
802,2021/1/29,CHO,IND,W 108-105,240,43,85,0.506,27,48,0.563,16,37,0.432,6,9,0.667,108,42,87,0.483,31,52,0.596,11,35,0.314,10,13,0.769,105
803,2021/1/29,IND,CHO,L 105-108,240,42,87,0.483,31,52,0.596,11,35,0.314,10,13,0.769,105,43,85,0.506,27,48,0.563,16,37,0.432,6,9,0.667,108
804,2021/1/29,MIN,PHI,L 94-118,240,35,82,0.427,25,49,0.51,10,33,0.303,14,18,0.778,94,39,87,0.448,31,71,0.437,8,16,0.5,32,38,0.842,118
805,2021/1/29,PHI,MIN,W 118-94,240,39,87,0.448,31,71,0.437,8,16,0.5,32,38,0.842,118,35,82,0.427,25,49,0.51,10,33,0.303,14,18,0.778,94
806,2021/1/29,MIL,NOP,L 126-131,240,48,96,0.5,35,61,0.574,13,35,0.371,17,22,0.773,126,45,96,0.469,24,48,0.5,21,48,0.438,20,28,0.714,131
807,2021/1/29,NOP,MIL,W 131-126,240,45,96,0.469,24,48,0.5,21,48,0.438,20,28,0.714,131,48,96,0.5,35,61,0.574,13,35,0.371,17,22,0.773,126
808,2021/1/29,CLE,NYK,L 81-102,240,29,84,0.345,21,58,0.362,8,26,0.308,15,18,0.833,81,39,80,0.488,29,53,0.547,10,27,0.37,14,16,0.875,102
809,2021/1/29,NYK,CLE,W 102-81,240,39,80,0.488,29,53,0.547,10,27,0.37,14,16,0.875,102,29,84,0.345,21,58,0.362,8,26,0.308,15,18,0.833,81
810,2021/1/29,BRK,OKC,W 147-125,240,57,100,0.57,38,55,0.691,19,45,0.422,14,16,0.875,147,40,86,0.465,24,48,0.5,16,38,0.421,29,34,0.853,125
811,2021/1/29,OKC,BRK,L 125-147,240,40,86,0.465,24,48,0.5,16,38,0.421,29,34,0.853,125,57,100,0.57,38,55,0.691,19,45,0.422,14,16,0.875,147
812,2021/1/29,LAC,ORL,W 116-90,240,46,94,0.489,33,57,0.579,13,37,0.351,11,11,1,116,32,89,0.36,22,56,0.393,10,33,0.303,16,18,0.889,90
813,2021/1/29,ORL,LAC,L 90-116,240,32,89,0.36,22,56,0.393,10,33,0.303,16,18,0.889,90,46,94,0.489,33,57,0.579,13,37,0.351,11,11,1,116
814,2021/1/29,DEN,SAS,L 109-119,240,41,78,0.526,27,47,0.574,14,31,0.452,13,20,0.65,109,44,81,0.543,34,58,0.586,10,23,0.435,21,26,0.808,119
815,2021/1/29,SAS,DEN,W 119-109,240,44,81,0.543,34,58,0.586,10,23,0.435,21,26,0.808,119,41,78,0.526,27,47,0.574,14,31,0.452,13,20,0.65,109
816,2021/1/29,SAC,TOR,W 126-124,240,43,78,0.551,27,42,0.643,16,36,0.444,24,31,0.774,126,42,86,0.488,29,54,0.537,13,32,0.406,27,33,0.818,124
817,2021/1/29,TOR,SAC,L 124-126,240,42,86,0.488,29,54,0.537,13,32,0.406,27,33,0.818,124,43,78,0.551,27,42,0.643,16,36,0.444,24,31,0.774,126
818,2021/1/29,DAL,UTA,L 101-120,240,37,86,0.43,28,53,0.528,9,33,0.273,18,27,0.667,101,38,87,0.437,18,39,0.462,20,48,0.417,24,26,0.923,120
819,2021/1/29,UTA,DAL,W 120-101,240,38,87,0.437,18,39,0.462,20,48,0.417,24,26,0.923,120,37,86,0.43,28,53,0.528,9,33,0.273,18,27,0.667,101
820,2021/1/29,ATL,WAS,W 116-100,240,39,87,0.448,27,50,0.54,12,37,0.324,26,34,0.765,116,31,85,0.365,24,57,0.421,7,28,0.25,31,38,0.816,100
821,2021/1/29,WAS,ATL,L 100-116,240,31,85,0.365,24,57,0.421,7,28,0.25,31,38,0.816,100,39,87,0.448,27,50,0.54,12,37,0.324,26,34,0.765,116
822,2021/1/28,DET,LAL,W 107-92,240,40,87,0.46,26,51,0.51,14,36,0.389,13,13,1,107,36,88,0.409,24,60,0.4,12,28,0.429,8,12,0.667,92
823,2021/1/28,LAL,DET,L 92-107,240,36,88,0.409,24,60,0.4,12,28,0.429,8,12,0.667,92,40,87,0.46,26,51,0.51,14,36,0.389,13,13,1,107
824,2021/1/28,HOU,POR,W 104-101,240,38,90,0.422,25,43,0.581,13,47,0.277,15,18,0.833,104,39,93,0.419,22,52,0.423,17,41,0.415,6,8,0.75,101
825,2021/1/28,POR,HOU,L 101-104,240,39,93,0.419,22,52,0.423,17,41,0.415,6,8,0.75,101,38,90,0.422,25,43,0.581,13,47,0.277,15,18,0.833,104
826,2021/1/28,LAC,MIA,W 109-105,240,36,87,0.414,19,45,0.422,17,42,0.405,20,22,0.909,109,40,90,0.444,27,57,0.474,13,33,0.394,12,15,0.8,105
827,2021/1/28,MIA,LAC,L 105-109,240,40,90,0.444,27,57,0.474,13,33,0.394,12,15,0.8,105,36,87,0.414,19,45,0.422,17,42,0.405,20,22,0.909,109
828,2021/1/28,GSW,PHO,L 93-114,240,38,99,0.384,27,61,0.443,11,38,0.289,6,8,0.75,93,41,88,0.466,30,56,0.536,11,32,0.344,21,23,0.913,114
829,2021/1/28,PHO,GSW,W 114-93,240,41,88,0.466,30,56,0.536,11,32,0.344,21,23,0.913,114,38,99,0.384,27,61,0.443,11,38,0.289,6,8,0.75,93
830,2021/1/27,ATL,BRK,L 128-132 (OT),265,45,94,0.479,32,61,0.525,13,33,0.394,25,28,0.893,128,52,98,0.531,41,66,0.621,11,32,0.344,17,20,0.85,132
831,2021/1/27,BRK,ATL,W 132-128 (OT),265,52,98,0.531,41,66,0.621,11,32,0.344,17,20,0.85,132,45,94,0.479,32,61,0.525,13,33,0.394,25,28,0.893,128
832,2021/1/27,CHO,IND,L 106-116,240,37,90,0.411,24,52,0.462,13,38,0.342,19,21,0.905,106,45,88,0.511,29,48,0.604,16,40,0.4,10,12,0.833,116
833,2021/1/27,IND,CHO,W 116-106,240,45,88,0.511,29,48,0.604,16,40,0.4,10,12,0.833,116,37,90,0.411,24,52,0.462,13,38,0.342,19,21,0.905,106
834,2021/1/27,CLE,DET,W 122-107,240,47,87,0.54,36,66,0.545,11,21,0.524,17,23,0.739,122,37,82,0.451,26,55,0.473,11,27,0.407,22,29,0.759,107
835,2021/1/27,DET,CLE,L 107-122,240,37,82,0.451,26,55,0.473,11,27,0.407,22,29,0.759,107,47,87,0.54,36,66,0.545,11,21,0.524,17,23,0.739,122
836,2021/1/27,GSW,MIN,W 123-111,240,45,85,0.529,30,51,0.588,15,34,0.441,18,23,0.783,123,37,87,0.425,23,51,0.451,14,36,0.389,23,33,0.697,111
837,2021/1/27,MIN,GSW,L 111-123,240,37,87,0.425,23,51,0.451,14,36,0.389,23,33,0.697,111,45,85,0.529,30,51,0.588,15,34,0.441,18,23,0.783,123
838,2021/1/27,DEN,MIA,W 109-82,240,42,92,0.457,28,49,0.571,14,43,0.326,11,11,1,109,30,80,0.375,17,35,0.486,13,45,0.289,9,11,0.818,82
839,2021/1/27,MIA,DEN,L 82-109,240,30,80,0.375,17,35,0.486,13,45,0.289,9,11,0.818,82,42,92,0.457,28,49,0.571,14,43,0.326,11,11,1,109
840,2021/1/27,NOP,WAS,W 124-106,240,46,89,0.517,29,46,0.63,17,43,0.395,15,24,0.625,124,37,92,0.402,24,54,0.444,13,38,0.342,19,21,0.905,106
841,2021/1/27,WAS,NOP,L 106-124,240,37,92,0.402,24,54,0.444,13,38,0.342,19,21,0.905,106,46,89,0.517,29,46,0.63,17,43,0.395,15,24,0.625,124
842,2021/1/27,ORL,SAC,L 107-121,240,40,96,0.417,30,70,0.429,10,26,0.385,17,18,0.944,107,45,92,0.489,31,59,0.525,14,33,0.424,17,26,0.654,121
843,2021/1/27,SAC,ORL,W 121-107,240,45,92,0.489,31,59,0.525,14,33,0.424,17,26,0.654,121,40,96,0.417,30,70,0.429,10,26,0.385,17,18,0.944,107
844,2021/1/27,LAL,PHI,L 106-107,240,41,86,0.477,33,62,0.532,8,24,0.333,16,25,0.64,106,41,85,0.482,32,60,0.533,9,25,0.36,16,26,0.615,107
845,2021/1/27,PHI,LAL,W 107-106,240,41,85,0.482,32,60,0.533,9,25,0.36,16,26,0.615,107,41,86,0.477,33,62,0.532,8,24,0.333,16,25,0.64,106
846,2021/1/27,OKC,PHO,W 102-97,240,38,85,0.447,22,45,0.489,16,40,0.4,10,14,0.714,102,36,95,0.379,21,52,0.404,15,43,0.349,10,12,0.833,97
847,2021/1/27,PHO,OKC,L 97-102,240,36,95,0.379,21,52,0.404,15,43,0.349,10,12,0.833,97,38,85,0.447,22,45,0.489,16,40,0.4,10,14,0.714,102
848,2021/1/27,BOS,SAS,L 106-110,240,42,98,0.429,32,68,0.471,10,30,0.333,12,14,0.857,106,46,82,0.561,38,54,0.704,8,28,0.286,10,16,0.625,110
849,2021/1/27,SAS,BOS,W 110-106,240,46,82,0.561,38,54,0.704,8,28,0.286,10,16,0.625,110,42,98,0.429,32,68,0.471,10,30,0.333,12,14,0.857,106
850,2021/1/27,MIL,TOR,W 115-108,240,40,93,0.43,24,49,0.49,16,44,0.364,19,26,0.731,115,38,94,0.404,16,39,0.41,22,55,0.4,10,12,0.833,108
851,2021/1/27,TOR,MIL,L 108-115,240,38,94,0.404,16,39,0.41,22,55,0.4,10,12,0.833,108,40,93,0.43,24,49,0.49,16,44,0.364,19,26,0.731,115
852,2021/1/27,DAL,UTA,L 104-116,240,42,91,0.462,30,56,0.536,12,35,0.343,8,9,0.889,104,42,91,0.462,26,50,0.52,16,41,0.39,16,21,0.762,116
853,2021/1/27,UTA,DAL,W 116-104,240,42,91,0.462,26,50,0.52,16,41,0.39,16,21,0.762,116,42,91,0.462,30,56,0.536,12,35,0.343,8,9,0.889,104
854,2021/1/26,ATL,LAC,W 108-99,240,37,80,0.463,27,54,0.5,10,26,0.385,24,25,0.96,108,36,89,0.404,28,63,0.444,8,26,0.308,19,22,0.864,99
855,2021/1/26,LAC,ATL,L 99-108,240,36,89,0.404,28,63,0.444,8,26,0.308,19,22,0.864,99,37,80,0.463,27,54,0.5,10,26,0.385,24,25,0.96,108
856,2021/1/26,HOU,WAS,W 107-88,240,37,88,0.42,25,51,0.49,12,37,0.324,21,29,0.724,107,33,85,0.388,28,59,0.475,5,26,0.192,17,23,0.739,88
857,2021/1/26,WAS,HOU,L 88-107,240,33,85,0.388,28,59,0.475,5,26,0.192,17,23,0.739,88,37,88,0.42,25,51,0.49,12,37,0.324,21,29,0.724,107
858,2021/1/26,NYK,UTA,L 94-108,240,36,83,0.434,26,56,0.464,10,27,0.37,12,17,0.706,94,37,92,0.402,22,44,0.5,15,48,0.313,19,22,0.864,108
859,2021/1/26,UTA,NYK,W 108-94,240,37,92,0.402,22,44,0.5,15,48,0.313,19,22,0.864,108,36,83,0.434,26,56,0.464,10,27,0.37,12,17,0.706,94
860,2021/1/25,BRK,MIA,W 98-85,240,34,85,0.4,23,47,0.489,11,38,0.289,19,22,0.864,98,31,84,0.369,20,41,0.488,11,43,0.256,12,17,0.706,85
861,2021/1/25,MIA,BRK,L 85-98,240,31,84,0.369,20,41,0.488,11,43,0.256,12,17,0.706,85,34,85,0.4,23,47,0.489,11,38,0.289,19,22,0.864,98
862,2021/1/25,BOS,CHI,W 119-103,240,44,87,0.506,29,58,0.5,15,29,0.517,16,20,0.8,119,41,88,0.466,24,49,0.49,17,39,0.436,4,10,0.4,103
863,2021/1/25,CHI,BOS,L 103-119,240,41,88,0.466,24,49,0.49,17,39,0.436,4,10,0.4,103,44,87,0.506,29,58,0.5,15,29,0.517,16,20,0.8,119
864,2021/1/25,CLE,LAL,L 108-115,240,40,86,0.465,31,65,0.477,9,21,0.429,19,22,0.864,108,42,87,0.483,32,55,0.582,10,32,0.313,21,28,0.75,115
865,2021/1/25,LAL,CLE,W 115-108,240,42,87,0.483,32,55,0.582,10,32,0.313,21,28,0.75,115,40,86,0.465,31,65,0.477,9,21,0.429,19,22,0.864,108
866,2021/1/25,DAL,DEN,L 113-117,240,41,84,0.488,30,52,0.577,11,32,0.344,20,24,0.833,113,40,79,0.506,25,44,0.568,15,35,0.429,22,28,0.786,117
867,2021/1/25,DEN,DAL,W 117-113,240,40,79,0.506,25,44,0.568,15,35,0.429,22,28,0.786,117,41,84,0.488,30,52,0.577,11,32,0.344,20,24,0.833,113
868,2021/1/25,DET,PHI,W 119-104,240,35,70,0.5,18,32,0.563,17,38,0.447,32,38,0.842,119,40,94,0.426,31,66,0.47,9,28,0.321,15,20,0.75,104
869,2021/1/25,PHI,DET,L 104-119,240,40,94,0.426,31,66,0.47,9,28,0.321,15,20,0.75,104,35,70,0.5,18,32,0.563,17,38,0.447,32,38,0.842,119
870,2021/1/25,GSW,MIN,W 130-108,240,44,89,0.494,30,59,0.508,14,30,0.467,28,37,0.757,130,39,94,0.415,31,70,0.443,8,24,0.333,22,25,0.88,108
871,2021/1/25,MIN,GSW,L 108-130,240,39,94,0.415,31,70,0.443,8,24,0.333,22,25,0.88,108,44,89,0.494,30,59,0.508,14,30,0.467,28,37,0.757,130
872,2021/1/25,IND,TOR,W 129-114,240,40,78,0.513,28,49,0.571,12,29,0.414,37,45,0.822,129,38,93,0.409,24,55,0.436,14,38,0.368,24,27,0.889,114
873,2021/1/25,TOR,IND,L 114-129,240,38,93,0.409,24,55,0.436,14,38,0.368,24,27,0.889,114,40,78,0.513,28,49,0.571,12,29,0.414,37,45,0.822,129
874,2021/1/25,CHO,ORL,L 108-117,240,39,89,0.438,28,51,0.549,11,38,0.289,19,27,0.704,108,42,88,0.477,23,51,0.451,19,37,0.514,14,22,0.636,117
875,2021/1/25,ORL,CHO,W 117-108,240,42,88,0.477,23,51,0.451,19,37,0.514,14,22,0.636,117,39,89,0.438,28,51,0.549,11,38,0.289,19,27,0.704,108
876,2021/1/25,OKC,POR,W 125-122,240,43,84,0.512,25,44,0.568,18,40,0.45,21,35,0.6,125,46,98,0.469,32,57,0.561,14,41,0.341,16,21,0.762,122
877,2021/1/25,POR,OKC,L 122-125,240,46,98,0.469,32,57,0.561,14,41,0.341,16,21,0.762,122,43,84,0.512,25,44,0.568,18,40,0.45,21,35,0.6,125
878,2021/1/24,BOS,CLE,W 141-103,240,52,93,0.559,38,65,0.585,14,28,0.5,23,27,0.852,141,34,85,0.4,24,52,0.462,10,33,0.303,25,34,0.735,103
879,2021/1/24,CLE,BOS,L 103-141,240,34,85,0.4,24,52,0.462,10,33,0.303,25,34,0.735,103,52,93,0.559,38,65,0.585,14,28,0.5,23,27,0.852,141
880,2021/1/24,IND,TOR,L 102-107,240,35,87,0.402,22,48,0.458,13,39,0.333,19,22,0.864,102,37,90,0.411,22,55,0.4,15,35,0.429,18,26,0.692,107
881,2021/1/24,TOR,IND,W 107-102,240,37,90,0.411,22,55,0.4,15,35,0.429,18,26,0.692,107,35,87,0.402,22,48,0.458,13,39,0.333,19,22,0.864,102
882,2021/1/24,LAC,OKC,W 108-100,240,41,92,0.446,27,46,0.587,14,46,0.304,12,16,0.75,108,42,95,0.442,35,60,0.583,7,35,0.2,9,14,0.643,100
883,2021/1/24,OKC,LAC,L 100-108,240,42,95,0.442,35,60,0.583,7,35,0.2,9,14,0.643,100,41,92,0.446,27,46,0.587,14,46,0.304,12,16,0.75,108
884,2021/1/24,ATL,MIL,L 115-129,240,42,83,0.506,28,44,0.636,14,39,0.359,17,22,0.773,115,50,91,0.549,40,60,0.667,10,31,0.323,19,27,0.704,129
885,2021/1/24,MIL,ATL,W 129-115,240,50,91,0.549,40,60,0.667,10,31,0.323,19,27,0.704,129,42,83,0.506,28,44,0.636,14,39,0.359,17,22,0.773,115
886,2021/1/24,CHO,ORL,W 107-104,240,42,88,0.477,28,52,0.538,14,36,0.389,9,16,0.563,107,39,87,0.448,22,49,0.449,17,38,0.447,9,13,0.692,104
887,2021/1/24,ORL,CHO,L 104-107,240,39,87,0.448,22,49,0.449,17,38,0.447,9,13,0.692,104,42,88,0.477,28,52,0.538,14,36,0.389,9,16,0.563,107
888,2021/1/24,NYK,POR,L 113-116,240,39,86,0.453,27,57,0.474,12,29,0.414,23,25,0.92,113,39,83,0.47,22,37,0.595,17,46,0.37,21,23,0.913,116
889,2021/1/24,POR,NYK,W 116-113,240,39,83,0.47,22,37,0.595,17,46,0.37,21,23,0.913,116,39,86,0.453,27,57,0.474,12,29,0.414,23,25,0.92,113
890,2021/1/24,SAS,WAS,W 121-101,240,48,96,0.5,33,65,0.508,15,31,0.484,10,11,0.909,121,39,92,0.424,25,50,0.5,14,42,0.333,9,14,0.643,101
891,2021/1/24,WAS,SAS,L 101-121,240,39,92,0.424,25,50,0.5,14,42,0.333,9,14,0.643,101,48,96,0.5,33,65,0.508,15,31,0.484,10,11,0.909,121
892,2021/1/23,BRK,MIA,W 128-124,240,44,83,0.53,25,46,0.543,19,37,0.514,21,26,0.808,128,42,89,0.472,29,43,0.674,13,46,0.283,27,32,0.844,124
893,2021/1/23,MIA,BRK,L 124-128,240,42,89,0.472,29,43,0.674,13,46,0.283,27,32,0.844,124,44,83,0.53,25,46,0.543,19,37,0.514,21,26,0.808,128
894,2021/1/23,CHI,LAL,L 90-101,240,33,84,0.393,25,59,0.424,8,25,0.32,16,22,0.727,90,36,79,0.456,32,60,0.533,4,19,0.211,25,31,0.806,101
895,2021/1/23,LAL,CHI,W 101-90,240,36,79,0.456,32,60,0.533,4,19,0.211,25,31,0.806,101,33,84,0.393,25,59,0.424,8,25,0.32,16,22,0.727,90
896,2021/1/23,DAL,HOU,L 108-133,240,37,83,0.446,32,58,0.552,5,25,0.2,29,40,0.725,108,47,86,0.547,31,49,0.633,16,37,0.432,23,29,0.793,133
897,2021/1/23,HOU,DAL,W 133-108,240,47,86,0.547,31,49,0.633,16,37,0.432,23,29,0.793,133,37,83,0.446,32,58,0.552,5,25,0.2,29,40,0.725,108
898,2021/1/23,DET,PHI,L 110-114,240,37,86,0.43,23,53,0.434,14,33,0.424,22,30,0.733,110,38,83,0.458,30,60,0.5,8,23,0.348,30,38,0.789,114
899,2021/1/23,PHI,DET,W 114-110,240,38,83,0.458,30,60,0.5,8,23,0.348,30,38,0.789,114,37,86,0.43,23,53,0.434,14,33,0.424,22,30,0.733,110
900,2021/1/23,MIN,NOP,W 120-110,240,39,91,0.429,27,57,0.474,12,34,0.353,30,37,0.811,120,40,87,0.46,30,54,0.556,10,33,0.303,20,28,0.714,110
901,2021/1/23,NOP,MIN,L 110-120,240,40,87,0.46,30,54,0.556,10,33,0.303,20,28,0.714,110,39,91,0.429,27,57,0.474,12,34,0.353,30,37,0.811,120
902,2021/1/23,DEN,PHO,W 120-112 (2OT),290,40,97,0.412,25,61,0.41,15,36,0.417,25,32,0.781,120,41,102,0.402,25,49,0.51,16,53,0.302,14,18,0.778,112
903,2021/1/23,PHO,DEN,L 112-120 (2OT),290,41,102,0.402,25,49,0.51,16,53,0.302,14,18,0.778,112,40,97,0.412,25,61,0.41,15,36,0.417,25,32,0.781,120
904,2021/1/23,GSW,UTA,L 108-127,240,42,93,0.452,28,54,0.519,14,39,0.359,10,15,0.667,108,45,94,0.479,25,44,0.568,20,50,0.4,17,22,0.773,127
905,2021/1/23,UTA,GSW,W 127-108,240,45,94,0.479,25,44,0.568,20,50,0.4,17,22,0.773,127,42,93,0.452,28,54,0.519,14,39,0.359,10,15,0.667,108
906,2021/1/22,CHI,CHO,W 123-110,240,49,96,0.51,34,53,0.642,15,43,0.349,10,12,0.833,123,42,85,0.494,35,53,0.66,7,32,0.219,19,25,0.76,110
907,2021/1/22,CHO,CHI,L 110-123,240,42,85,0.494,35,53,0.66,7,32,0.219,19,25,0.76,110,49,96,0.51,34,53,0.642,15,43,0.349,10,12,0.833,123
908,2021/1/22,BRK,CLE,L 113-125,240,42,87,0.483,28,44,0.636,14,43,0.326,15,17,0.882,113,45,87,0.517,37,62,0.597,8,25,0.32,27,32,0.844,125
909,2021/1/22,CLE,BRK,W 125-113,240,45,87,0.517,37,62,0.597,8,25,0.32,27,32,0.844,125,42,87,0.483,28,44,0.636,14,43,0.326,15,17,0.882,113
910,2021/1/22,DET,HOU,L 102-103,240,31,82,0.378,16,50,0.32,15,32,0.469,25,37,0.676,102,37,95,0.389,23,54,0.426,14,41,0.341,15,20,0.75,103
911,2021/1/22,HOU,DET,W 103-102,240,37,95,0.389,23,54,0.426,14,41,0.341,15,20,0.75,103,31,82,0.378,16,50,0.32,15,32,0.469,25,37,0.676,102
912,2021/1/22,IND,ORL,W 120-118 (OT),265,46,93,0.495,34,59,0.576,12,34,0.353,16,18,0.889,120,43,94,0.457,26,57,0.456,17,37,0.459,15,24,0.625,118
913,2021/1/22,ORL,IND,L 118-120 (OT),265,43,94,0.457,26,57,0.456,17,37,0.459,15,24,0.625,118,46,93,0.495,34,59,0.576,12,34,0.353,16,18,0.889,120
914,2021/1/22,LAC,OKC,W 120-106,240,43,84,0.512,33,51,0.647,10,33,0.303,24,25,0.96,120,41,87,0.471,27,45,0.6,14,42,0.333,10,13,0.769,106
915,2021/1/22,OKC,LAC,L 106-120,240,41,87,0.471,27,45,0.6,14,42,0.333,10,13,0.769,106,43,84,0.512,33,51,0.647,10,33,0.303,24,25,0.96,120
916,2021/1/22,ATL,MIN,W 116-98,240,38,83,0.458,23,48,0.479,15,35,0.429,25,30,0.833,116,40,93,0.43,32,61,0.525,8,32,0.25,10,12,0.833,98
917,2021/1/22,MIN,ATL,L 98-116,240,40,93,0.43,32,61,0.525,8,32,0.25,10,12,0.833,98,38,83,0.458,23,48,0.479,15,35,0.429,25,30,0.833,116
918,2021/1/22,BOS,PHI,L 110-122,240,41,90,0.456,29,60,0.483,12,30,0.4,16,20,0.8,110,45,81,0.556,33,53,0.623,12,28,0.429,20,24,0.833,122
919,2021/1/22,PHI,BOS,W 122-110,240,45,81,0.556,33,53,0.623,12,28,0.429,20,24,0.833,122,41,90,0.456,29,60,0.483,12,30,0.4,16,20,0.8,110
920,2021/1/22,DEN,PHO,W 130-126 (OT),265,53,103,0.515,47,77,0.61,6,26,0.231,18,19,0.947,130,47,94,0.5,30,50,0.6,17,44,0.386,15,15,1,126
921,2021/1/22,PHO,DEN,L 126-130 (OT),265,47,94,0.5,30,50,0.6,17,44,0.386,15,15,1,126,53,103,0.515,47,77,0.61,6,26,0.231,18,19,0.947,130
922,2021/1/22,NYK,SAC,L 94-103,240,36,94,0.383,31,72,0.431,5,22,0.227,17,25,0.68,94,38,91,0.418,26,57,0.456,12,34,0.353,15,21,0.714,103
923,2021/1/22,SAC,NYK,W 103-94,240,38,91,0.418,26,57,0.456,12,34,0.353,15,21,0.714,103,36,94,0.383,31,72,0.431,5,22,0.227,17,25,0.68,94
924,2021/1/22,DAL,SAS,W 122-117,240,45,93,0.484,31,54,0.574,14,39,0.359,18,20,0.9,122,41,89,0.461,29,61,0.475,12,28,0.429,23,30,0.767,117
925,2021/1/22,SAS,DAL,L 117-122,240,41,89,0.461,29,61,0.475,12,28,0.429,23,30,0.767,117,45,93,0.484,31,54,0.574,14,39,0.359,18,20,0.9,122
926,2021/1/22,MIA,TOR,L 81-101,240,33,77,0.429,26,46,0.565,7,31,0.226,8,10,0.8,81,39,84,0.464,22,44,0.5,17,40,0.425,6,9,0.667,101
927,2021/1/22,TOR,MIA,W 101-81,240,39,84,0.464,22,44,0.5,17,40,0.425,6,9,0.667,101,33,77,0.429,26,46,0.565,7,31,0.226,8,10,0.8,81
928,2021/1/21,GSW,NYK,L 104-119,240,33,86,0.384,24,48,0.5,9,38,0.237,29,39,0.744,104,38,82,0.463,27,58,0.466,11,24,0.458,32,41,0.78,119
929,2021/1/21,NYK,GSW,W 119-104,240,38,82,0.463,27,58,0.466,11,24,0.458,32,41,0.78,119,33,86,0.384,24,48,0.5,9,38,0.237,29,39,0.744,104
930,2021/1/21,LAL,MIL,W 113-106,240,41,88,0.466,22,51,0.431,19,37,0.514,12,15,0.8,113,44,87,0.506,35,59,0.593,9,28,0.321,9,12,0.75,106
931,2021/1/21,MIL,LAL,L 106-113,240,44,87,0.506,35,59,0.593,9,28,0.321,9,12,0.75,106,41,88,0.466,22,51,0.431,19,37,0.514,12,15,0.8,113
932,2021/1/21,NOP,UTA,L 118-129,240,42,85,0.494,31,60,0.517,11,25,0.44,23,30,0.767,118,44,88,0.5,27,49,0.551,17,39,0.436,24,25,0.96,129
933,2021/1/21,UTA,NOP,W 129-118,240,44,88,0.5,27,49,0.551,17,39,0.436,24,25,0.96,129,42,85,0.494,31,60,0.517,11,25,0.44,23,30,0.767,118
934,2021/1/20,ATL,DET,W 123-115 (OT),265,44,100,0.44,35,77,0.455,9,23,0.391,26,38,0.684,123,44,97,0.454,34,66,0.515,10,31,0.323,17,19,0.895,115
935,2021/1/20,DET,ATL,L 115-123 (OT),265,44,97,0.454,34,66,0.515,10,31,0.323,17,19,0.895,115,44,100,0.44,35,77,0.455,9,23,0.391,26,38,0.684,123
936,2021/1/20,BRK,CLE,L 135-147 (2OT),290,48,106,0.453,33,65,0.508,15,41,0.366,24,27,0.889,135,56,109,0.514,36,69,0.522,20,40,0.5,15,21,0.714,147
937,2021/1/20,CLE,BRK,W 147-135 (2OT),290,56,109,0.514,36,69,0.522,20,40,0.5,15,21,0.714,147,48,106,0.453,33,65,0.508,15,41,0.366,24,27,0.889,135
938,2021/1/20,GSW,SAS,W 121-99,240,46,91,0.505,31,53,0.585,15,38,0.395,14,20,0.7,121,35,94,0.372,31,61,0.508,4,33,0.121,25,31,0.806,99
939,2021/1/20,SAS,GSW,L 99-121,240,35,94,0.372,31,61,0.508,4,33,0.121,25,31,0.806,99,46,91,0.505,31,53,0.585,15,38,0.395,14,20,0.7,121
940,2021/1/20,HOU,PHO,L 103-109,240,37,88,0.42,27,57,0.474,10,31,0.323,19,22,0.864,103,42,89,0.472,34,55,0.618,8,34,0.235,17,19,0.895,109
941,2021/1/20,PHO,HOU,W 109-103,240,42,89,0.472,34,55,0.618,8,34,0.235,17,19,0.895,109,37,88,0.42,27,57,0.474,10,31,0.323,19,22,0.864,103
942,2021/1/20,DAL,IND,W 124-112,240,51,97,0.526,43,70,0.614,8,27,0.296,14,17,0.824,124,41,92,0.446,25,53,0.472,16,39,0.41,14,21,0.667,112
943,2021/1/20,IND,DAL,L 112-124,240,41,92,0.446,25,53,0.472,16,39,0.41,14,21,0.667,112,51,97,0.526,43,70,0.614,8,27,0.296,14,17,0.824,124
944,2021/1/20,LAC,SAC,W 115-96,240,41,86,0.477,25,51,0.49,16,35,0.457,17,18,0.944,115,39,86,0.453,26,58,0.448,13,28,0.464,5,12,0.417,96
945,2021/1/20,SAC,LAC,L 96-115,240,39,86,0.453,26,58,0.448,13,28,0.464,5,12,0.417,96,41,86,0.477,25,51,0.49,16,35,0.457,17,18,0.944,115
946,2021/1/20,MIN,ORL,L 96-97,240,36,85,0.424,21,50,0.42,15,35,0.429,9,14,0.643,96,36,92,0.391,26,61,0.426,10,31,0.323,15,21,0.714,97
947,2021/1/20,ORL,MIN,W 97-96,240,36,92,0.391,26,61,0.426,10,31,0.323,15,21,0.714,97,36,85,0.424,21,50,0.42,15,35,0.429,9,14,0.643,96
948,2021/1/20,BOS,PHI,L 109-117,240,42,89,0.472,30,56,0.536,12,33,0.364,13,20,0.65,109,36,78,0.462,27,51,0.529,9,27,0.333,36,45,0.8,117
949,2021/1/20,PHI,BOS,W 117-109,240,36,78,0.462,27,51,0.529,9,27,0.333,36,45,0.8,117,42,89,0.472,30,56,0.536,12,33,0.364,13,20,0.65,109
950,2021/1/20,MIA,TOR,W 111-102,240,39,80,0.488,21,40,0.525,18,40,0.45,15,17,0.882,111,35,88,0.398,19,39,0.487,16,49,0.327,16,18,0.889,102
951,2021/1/20,TOR,MIA,L 102-111,240,35,88,0.398,19,39,0.487,16,49,0.327,16,18,0.889,102,39,80,0.488,21,40,0.525,18,40,0.45,15,17,0.882,111
952,2021/1/19,DEN,OKC,W 119-101,240,46,105,0.438,32,63,0.508,14,42,0.333,13,14,0.929,119,36,86,0.419,22,43,0.512,14,43,0.326,15,23,0.652,101
953,2021/1/19,OKC,DEN,L 101-119,240,36,86,0.419,22,43,0.512,14,43,0.326,15,23,0.652,101,46,105,0.438,32,63,0.508,14,42,0.333,13,14,0.929,119
954,2021/1/19,NOP,UTA,L 102-118,240,43,95,0.453,37,69,0.536,6,26,0.231,10,15,0.667,102,43,85,0.506,22,38,0.579,21,47,0.447,11,17,0.647,118
955,2021/1/19,UTA,NOP,W 118-102,240,43,85,0.506,22,38,0.579,21,47,0.447,11,17,0.647,118,43,95,0.453,37,69,0.536,6,26,0.231,10,15,0.667,102
956,2021/1/18,ATL,MIN,W 108-97,240,37,79,0.468,26,51,0.51,11,28,0.393,23,25,0.92,108,36,91,0.396,22,54,0.407,14,37,0.378,11,16,0.688,97
957,2021/1/18,MIN,ATL,L 97-108,240,36,91,0.396,22,54,0.407,14,37,0.378,11,16,0.688,97,37,79,0.468,26,51,0.51,11,28,0.393,23,25,0.92,108
958,2021/1/18,BRK,MIL,W 125-123,240,46,84,0.548,31,53,0.585,15,31,0.484,18,21,0.857,125,46,105,0.438,35,67,0.522,11,38,0.289,20,24,0.833,123
959,2021/1/18,MIL,BRK,L 123-125,240,46,105,0.438,35,67,0.522,11,38,0.289,20,24,0.833,123,46,84,0.548,31,53,0.585,15,31,0.484,18,21,0.857,125
960,2021/1/18,CHI,HOU,W 125-120,240,43,92,0.467,23,47,0.489,20,45,0.444,19,21,0.905,125,46,88,0.523,29,48,0.604,17,40,0.425,11,17,0.647,120
961,2021/1/18,HOU,CHI,L 120-125,240,46,88,0.523,29,48,0.604,17,40,0.425,11,17,0.647,120,43,92,0.467,23,47,0.489,20,45,0.444,19,21,0.905,125
962,2021/1/18,GSW,LAL,W 115-113,240,44,87,0.506,32,50,0.64,12,37,0.324,15,20,0.75,115,40,83,0.482,31,54,0.574,9,29,0.31,24,33,0.727,113
963,2021/1/18,LAL,GSW,L 113-115,240,40,83,0.482,31,54,0.574,9,29,0.31,24,33,0.727,113,44,87,0.506,32,50,0.64,12,37,0.324,15,20,0.75,115
964,2021/1/18,MEM,PHO,W 108-104,240,41,83,0.494,30,57,0.526,11,26,0.423,15,20,0.75,108,40,88,0.455,25,52,0.481,15,36,0.417,9,16,0.563,104
965,2021/1/18,PHO,MEM,L 104-108,240,40,88,0.455,25,52,0.481,15,36,0.417,9,16,0.563,104,41,83,0.494,30,57,0.526,11,26,0.423,15,20,0.75,108
966,2021/1/18,DET,MIA,L 107-113,240,38,82,0.463,25,45,0.556,13,37,0.351,18,24,0.75,107,43,75,0.573,31,45,0.689,12,30,0.4,15,19,0.789,113
967,2021/1/18,MIA,DET,W 113-107,240,43,75,0.573,31,45,0.689,12,30,0.4,15,19,0.789,113,38,82,0.463,25,45,0.556,13,37,0.351,18,24,0.75,107
968,2021/1/18,NYK,ORL,W 91-84,240,31,87,0.356,26,60,0.433,5,27,0.185,24,34,0.706,91,29,86,0.337,17,48,0.354,12,38,0.316,14,16,0.875,84
969,2021/1/18,ORL,NYK,L 84-91,240,29,86,0.337,17,48,0.354,12,38,0.316,14,16,0.875,84,31,87,0.356,26,60,0.433,5,27,0.185,24,34,0.706,91
970,2021/1/18,POR,SAS,L 104-125,240,39,90,0.433,29,55,0.527,10,35,0.286,16,19,0.842,104,48,90,0.533,33,57,0.579,15,33,0.455,14,16,0.875,125
971,2021/1/18,SAS,POR,W 125-104,240,48,90,0.533,33,57,0.579,15,33,0.455,14,16,0.875,125,39,90,0.433,29,55,0.527,10,35,0.286,16,19,0.842,104
972,2021/1/18,DAL,TOR,L 93-116,240,31,82,0.378,22,46,0.478,9,36,0.25,22,27,0.815,93,44,88,0.5,32,55,0.582,12,33,0.364,16,18,0.889,116
973,2021/1/18,TOR,DAL,W 116-93,240,44,88,0.5,32,55,0.582,12,33,0.364,16,18,0.889,116,31,82,0.378,22,46,0.478,9,36,0.25,22,27,0.815,93
974,2021/1/17,BOS,NYK,L 75-105,240,25,84,0.298,18,38,0.474,7,46,0.152,18,29,0.621,75,38,80,0.475,26,49,0.531,12,31,0.387,17,21,0.81,105
975,2021/1/17,NYK,BOS,W 105-75,240,38,80,0.475,26,49,0.531,12,31,0.387,17,21,0.81,105,25,84,0.298,18,38,0.474,7,46,0.152,18,29,0.621,75
976,2021/1/17,CHI,DAL,W 117-101,240,43,85,0.506,36,60,0.6,7,25,0.28,24,33,0.727,117,41,93,0.441,33,62,0.532,8,31,0.258,11,19,0.579,101
977,2021/1/17,DAL,CHI,L 101-117,240,41,93,0.441,33,62,0.532,8,31,0.258,11,19,0.579,101,43,85,0.506,36,60,0.6,7,25,0.28,24,33,0.727,117
978,2021/1/17,DEN,UTA,L 105-109,240,40,100,0.4,26,63,0.413,14,37,0.378,11,15,0.733,105,39,76,0.513,24,39,0.615,15,37,0.405,16,28,0.571,109
979,2021/1/17,UTA,DEN,W 109-105,240,39,76,0.513,24,39,0.615,15,37,0.405,16,28,0.571,109,40,100,0.4,26,63,0.413,14,37,0.378,11,15,0.733,105
980,2021/1/17,IND,LAC,L 96-129,240,37,89,0.416,26,51,0.51,11,38,0.289,11,16,0.688,96,48,87,0.552,29,48,0.604,19,39,0.487,14,20,0.7,129
981,2021/1/17,LAC,IND,W 129-96,240,48,87,0.552,29,48,0.604,19,39,0.487,14,20,0.7,129,37,89,0.416,26,51,0.51,11,38,0.289,11,16,0.688,96
982,2021/1/17,NOP,SAC,W 128-123,240,45,85,0.529,34,63,0.54,11,22,0.5,27,34,0.794,128,47,91,0.516,34,52,0.654,13,39,0.333,16,18,0.889,123
983,2021/1/17,SAC,NOP,L 123-128,240,47,91,0.516,34,52,0.654,13,39,0.333,16,18,0.889,123,45,85,0.529,34,63,0.54,11,22,0.5,27,34,0.794,128
984,2021/1/16,BRK,ORL,W 122-115,240,42,78,0.538,26,43,0.605,16,35,0.457,22,25,0.88,122,44,95,0.463,30,49,0.612,14,46,0.304,13,16,0.813,115
985,2021/1/16,ORL,BRK,L 115-122,240,44,95,0.463,30,49,0.612,14,46,0.304,13,16,0.813,115,42,78,0.538,26,43,0.605,16,35,0.457,22,25,0.88,122
986,2021/1/16,MEM,PHI,W 106-104,240,43,99,0.434,35,70,0.5,8,29,0.276,12,18,0.667,106,37,84,0.44,30,59,0.508,7,25,0.28,23,32,0.719,104
987,2021/1/16,PHI,MEM,L 104-106,240,37,84,0.44,30,59,0.508,7,25,0.28,23,32,0.719,104,43,99,0.434,35,70,0.5,8,29,0.276,12,18,0.667,106
988,2021/1/16,DET,MIA,W 120-100,240,46,91,0.505,28,45,0.622,18,46,0.391,10,15,0.667,120,32,67,0.478,20,38,0.526,12,29,0.414,24,27,0.889,100
989,2021/1/16,MIA,DET,L 100-120,240,32,67,0.478,20,38,0.526,12,29,0.414,24,27,0.889,100,46,91,0.505,28,45,0.622,18,46,0.391,10,15,0.667,120
990,2021/1/16,ATL,POR,L 106-112,240,38,87,0.437,32,57,0.561,6,30,0.2,24,28,0.857,106,40,103,0.388,25,59,0.424,15,44,0.341,17,20,0.85,112
991,2021/1/16,POR,ATL,W 112-106,240,40,103,0.388,25,59,0.424,15,44,0.341,17,20,0.85,112,38,87,0.437,32,57,0.561,6,30,0.2,24,28,0.857,106
992,2021/1/16,HOU,SAS,L 91-103,240,31,84,0.369,19,52,0.365,12,32,0.375,17,27,0.63,91,40,100,0.4,35,76,0.461,5,24,0.208,18,23,0.783,103
993,2021/1/16,SAS,HOU,W 103-91,240,40,100,0.4,35,76,0.461,5,24,0.208,18,23,0.783,103,31,84,0.369,19,52,0.365,12,32,0.375,17,27,0.63,91
994,2021/1/16,CHO,TOR,L 113-116,240,38,87,0.437,23,51,0.451,15,36,0.417,22,29,0.759,113,36,86,0.419,15,37,0.405,21,49,0.429,23,26,0.885,116
995,2021/1/16,TOR,CHO,W 116-113,240,36,86,0.419,15,37,0.405,21,49,0.429,23,26,0.885,116,38,87,0.437,23,51,0.451,15,36,0.417,22,29,0.759,113
996,2021/1/15,BOS,ORL,W 124-97,240,45,88,0.511,28,46,0.609,17,42,0.405,17,19,0.895,124,38,94,0.404,31,66,0.47,7,28,0.25,14,22,0.636,97
997,2021/1/15,ORL,BOS,L 97-124,240,38,94,0.404,31,66,0.47,7,28,0.25,14,22,0.636,97,45,88,0.511,28,46,0.609,17,42,0.405,17,19,0.895,124
998,2021/1/15,CLE,NYK,W 106-103,240,36,79,0.456,27,52,0.519,9,27,0.333,25,34,0.735,106,40,82,0.488,31,57,0.544,9,25,0.36,14,16,0.875,103
999,2021/1/15,NYK,CLE,L 103-106,240,40,82,0.488,31,57,0.544,9,25,0.36,14,16,0.875,103,36,79,0.456,27,52,0.519,9,27,0.333,25,34,0.735,106
1000,2021/1/15,LAL,NOP,W 112-95,240,39,93,0.419,24,56,0.429,15,37,0.405,19,26,0.731,112,41,86,0.477,32,57,0.561,9,29,0.31,4,8,0.5,95
1001,2021/1/15,NOP,LAL,L 95-112,240,41,86,0.477,32,57,0.561,9,29,0.31,4,8,0.5,95,39,93,0.419,24,56,0.429,15,37,0.405,19,26,0.731,112
1002,2021/1/15,DAL,MIL,L 109-112,240,45,97,0.464,32,61,0.525,13,36,0.361,6,13,0.462,109,43,96,0.448,29,59,0.492,14,37,0.378,12,25,0.48,112
1003,2021/1/15,MIL,DAL,W 112-109,240,43,96,0.448,29,59,0.492,14,37,0.378,12,25,0.48,112,45,97,0.464,32,61,0.525,13,36,0.361,6,13,0.462,109
1004,2021/1/15,CHI,OKC,L 125-127 (OT),265,43,91,0.473,22,45,0.489,21,46,0.457,18,25,0.72,125,48,105,0.457,33,60,0.55,15,45,0.333,16,24,0.667,127
1005,2021/1/15,OKC,CHI,W 127-125 (OT),265,48,105,0.457,33,60,0.55,15,45,0.333,16,24,0.667,127,43,91,0.473,22,45,0.489,21,46,0.457,18,25,0.72,125
1006,2021/1/15,LAC,SAC,W 138-100,240,52,89,0.584,34,54,0.63,18,35,0.514,16,20,0.8,138,40,85,0.471,32,59,0.542,8,26,0.308,12,17,0.706,100
1007,2021/1/15,SAC,LAC,L 100-138,240,40,85,0.471,32,59,0.542,8,26,0.308,12,17,0.706,100,52,89,0.584,34,54,0.63,18,35,0.514,16,20,0.8,138
1008,2021/1/15,ATL,UTA,L 92-116,240,38,92,0.413,33,64,0.516,5,28,0.179,11,15,0.733,92,43,92,0.467,23,48,0.479,20,44,0.455,10,14,0.714,116
1009,2021/1/15,UTA,ATL,W 116-92,240,43,92,0.467,23,48,0.479,20,44,0.455,10,14,0.714,116,38,92,0.413,33,64,0.516,5,28,0.179,11,15,0.733,92
1010,2021/1/14,DEN,GSW,W 114-104,240,41,90,0.456,30,53,0.566,11,37,0.297,21,27,0.778,114,38,81,0.469,27,52,0.519,11,29,0.379,17,24,0.708,104
1011,2021/1/14,GSW,DEN,L 104-114,240,38,81,0.469,27,52,0.519,11,29,0.379,17,24,0.708,104,41,90,0.456,30,53,0.566,11,37,0.297,21,27,0.778,114
1012,2021/1/14,MIA,PHI,L 108-125,240,40,81,0.494,28,47,0.596,12,34,0.353,16,26,0.615,108,44,82,0.537,27,45,0.6,17,37,0.459,20,24,0.833,125
1013,2021/1/14,PHI,MIA,W 125-108,240,44,82,0.537,27,45,0.6,17,37,0.459,20,24,0.833,125,40,81,0.494,28,47,0.596,12,34,0.353,16,26,0.615,108
1014,2021/1/14,IND,POR,W 111-87,240,44,92,0.478,35,62,0.565,9,30,0.3,14,18,0.778,111,32,87,0.368,19,44,0.432,13,43,0.302,10,10,1,87
1015,2021/1/14,POR,IND,L 87-111,240,32,87,0.368,19,44,0.432,13,43,0.302,10,10,1,87,44,92,0.478,35,62,0.565,9,30,0.3,14,18,0.778,111
1016,2021/1/14,HOU,SAS,W 109-105,240,42,86,0.488,29,53,0.547,13,33,0.394,12,19,0.632,109,42,92,0.457,33,61,0.541,9,31,0.29,12,16,0.75,105
1017,2021/1/14,SAS,HOU,L 105-109,240,42,92,0.457,33,61,0.541,9,31,0.29,12,16,0.75,105,42,86,0.488,29,53,0.547,13,33,0.394,12,19,0.632,109
1018,2021/1/14,CHO,TOR,L 108-111,240,42,87,0.483,27,52,0.519,15,35,0.429,9,12,0.75,108,40,88,0.455,20,38,0.526,20,50,0.4,11,13,0.846,111
1019,2021/1/14,TOR,CHO,W 111-108,240,40,88,0.455,20,38,0.526,20,50,0.4,11,13,0.846,111,42,87,0.483,27,52,0.519,15,35,0.429,9,12,0.75,108
1020,2021/1/13,CHO,DAL,L 93-104,240,38,100,0.38,28,62,0.452,10,38,0.263,7,14,0.5,93,40,96,0.417,25,50,0.5,15,46,0.326,9,16,0.563,104
1021,2021/1/13,DAL,CHO,W 104-93,240,40,96,0.417,25,50,0.5,15,46,0.326,9,16,0.563,104,38,100,0.38,28,62,0.452,10,38,0.263,7,14,0.5,93
1022,2021/1/13,DET,MIL,L 101-110,240,36,92,0.391,22,57,0.386,14,35,0.4,15,22,0.682,101,41,85,0.482,22,42,0.524,19,43,0.442,9,14,0.643,110
1023,2021/1/13,MIL,DET,W 110-101,240,41,85,0.482,22,42,0.524,19,43,0.442,9,14,0.643,110,36,92,0.391,22,57,0.386,14,35,0.4,15,22,0.682,101
1024,2021/1/13,LAC,NOP,W 111-106,240,35,74,0.473,17,37,0.459,18,37,0.486,23,27,0.852,111,42,88,0.477,32,60,0.533,10,28,0.357,12,16,0.75,106
1025,2021/1/13,NOP,LAC,L 106-111,240,42,88,0.477,32,60,0.533,10,28,0.357,12,16,0.75,106,35,74,0.473,17,37,0.459,18,37,0.486,23,27,0.852,111
1026,2021/1/13,MEM,MIN,W 118-107,240,50,106,0.472,42,81,0.519,8,25,0.32,10,13,0.769,118,39,90,0.433,30,53,0.566,9,37,0.243,20,24,0.833,107
1027,2021/1/13,MIN,MEM,L 107-118,240,39,90,0.433,30,53,0.566,9,37,0.243,20,24,0.833,107,50,106,0.472,42,81,0.519,8,25,0.32,10,13,0.769,118
1028,2021/1/13,BRK,NYK,W 116-109,240,44,91,0.484,28,51,0.549,16,40,0.4,12,17,0.706,116,44,92,0.478,33,64,0.516,11,28,0.393,10,12,0.833,109
1029,2021/1/13,NYK,BRK,L 109-116,240,44,92,0.478,33,64,0.516,11,28,0.393,10,12,0.833,109,44,91,0.484,28,51,0.549,16,40,0.4,12,17,0.706,116
1030,2021/1/13,LAL,OKC,W 128-99,240,47,95,0.495,30,58,0.517,17,37,0.459,17,22,0.773,128,37,86,0.43,27,55,0.491,10,31,0.323,15,19,0.789,99
1031,2021/1/13,OKC,LAL,L 99-128,240,37,86,0.43,27,55,0.491,10,31,0.323,15,19,0.789,99,47,95,0.495,30,58,0.517,17,37,0.459,17,22,0.773,128
1032,2021/1/13,POR,SAC,W 132-126,240,44,90,0.489,21,42,0.5,23,48,0.479,21,27,0.778,132,44,84,0.524,25,46,0.543,19,38,0.5,19,26,0.731,126
1033,2021/1/13,SAC,POR,L 126-132,240,44,84,0.524,25,46,0.543,19,38,0.5,19,26,0.731,126,44,90,0.489,21,42,0.5,23,48,0.479,21,27,0.778,132
1034,2021/1/12,BRK,DEN,W 122-116,240,48,79,0.608,32,47,0.681,16,32,0.5,10,15,0.667,122,44,88,0.5,26,51,0.51,18,37,0.486,10,16,0.625,116
1035,2021/1/12,DEN,BRK,L 116-122,240,44,88,0.5,26,51,0.51,18,37,0.486,10,16,0.625,116,48,79,0.608,32,47,0.681,16,32,0.5,10,15,0.667,122
1036,2021/1/12,CLE,UTA,L 87-117,240,35,90,0.389,27,59,0.458,8,31,0.258,9,14,0.643,87,42,84,0.5,18,39,0.462,24,45,0.533,9,12,0.75,117
1037,2021/1/12,UTA,CLE,W 117-87,240,42,84,0.5,18,39,0.462,24,45,0.533,9,12,0.75,117,35,90,0.389,27,59,0.458,8,31,0.258,9,14,0.643,87
1038,2021/1/12,GSW,IND,L 95-104,240,34,89,0.382,21,51,0.412,13,38,0.342,14,22,0.636,95,39,88,0.443,30,60,0.5,9,28,0.321,17,25,0.68,104
1039,2021/1/12,IND,GSW,W 104-95,240,39,88,0.443,30,60,0.5,9,28,0.321,17,25,0.68,104,34,89,0.382,21,51,0.412,13,38,0.342,14,22,0.636,95
1040,2021/1/12,HOU,LAL,L 100-117,240,38,97,0.392,26,57,0.456,12,40,0.3,12,16,0.75,100,42,84,0.5,28,52,0.538,14,32,0.438,19,27,0.704,117
1041,2021/1/12,LAL,HOU,W 117-100,240,42,84,0.5,28,52,0.538,14,32,0.438,19,27,0.704,117,38,97,0.392,26,57,0.456,12,40,0.3,12,16,0.75,100
1042,2021/1/12,OKC,SAS,L 102-112,240,36,83,0.434,29,57,0.509,7,26,0.269,23,29,0.793,102,41,95,0.432,31,60,0.517,10,35,0.286,20,22,0.909,112
1043,2021/1/12,SAS,OKC,W 112-102,240,41,95,0.432,31,60,0.517,10,35,0.286,20,22,0.909,112,36,83,0.434,29,57,0.509,7,26,0.269,23,29,0.793,102
1044,2021/1/12,MIA,PHI,L 134-137 (OT),265,48,104,0.462,29,48,0.604,19,56,0.339,19,24,0.792,134,50,102,0.49,31,47,0.66,19,55,0.345,18,25,0.72,137
1045,2021/1/12,PHI,MIA,W 137-134 (OT),265,50,102,0.49,31,47,0.66,19,55,0.345,18,25,0.72,137,48,104,0.462,29,48,0.604,19,56,0.339,19,24,0.792,134
1046,2021/1/11,ATL,PHI,W 112-94,240,37,99,0.374,20,55,0.364,17,44,0.386,21,27,0.778,112,37,92,0.402,29,56,0.518,8,36,0.222,12,13,0.923,94
1047,2021/1/11,PHI,ATL,L 94-112,240,37,92,0.402,29,56,0.518,8,36,0.222,12,13,0.923,94,37,99,0.374,20,55,0.364,17,44,0.386,21,27,0.778,112
1048,2021/1/11,CHO,NYK,W 109-88,240,38,78,0.487,25,46,0.543,13,32,0.406,20,23,0.87,109,34,87,0.391,25,50,0.5,9,37,0.243,11,17,0.647,88
1049,2021/1/11,NYK,CHO,L 88-109,240,34,87,0.391,25,50,0.5,9,37,0.243,11,17,0.647,88,38,78,0.487,25,46,0.543,13,32,0.406,20,23,0.87,109
1050,2021/1/11,CLE,MEM,L 91-101,240,37,82,0.451,26,56,0.464,11,26,0.423,6,14,0.429,91,40,78,0.513,35,58,0.603,5,20,0.25,16,21,0.762,101
1051,2021/1/11,MEM,CLE,W 101-91,240,40,78,0.513,35,58,0.603,5,20,0.25,16,21,0.762,101,37,82,0.451,26,56,0.464,11,26,0.423,6,14,0.429,91
1052,2021/1/11,MIL,ORL,W 121-99,240,46,91,0.505,33,56,0.589,13,35,0.371,16,20,0.8,121,39,91,0.429,28,60,0.467,11,31,0.355,10,13,0.769,99
1053,2021/1/11,ORL,MIL,L 99-121,240,39,91,0.429,28,60,0.467,11,31,0.355,10,13,0.769,99,46,91,0.505,33,56,0.589,13,35,0.371,16,20,0.8,121
1054,2021/1/11,POR,TOR,W 112-111,240,38,83,0.458,24,41,0.585,14,42,0.333,22,25,0.88,112,40,89,0.449,21,42,0.5,19,47,0.404,12,12,1,111
1055,2021/1/11,TOR,POR,L 111-112,240,40,89,0.449,21,42,0.5,19,47,0.404,12,12,1,111,38,83,0.458,24,41,0.585,14,42,0.333,22,25,0.88,112
1056,2021/1/11,IND,SAC,L 122-127,240,47,97,0.485,34,58,0.586,13,39,0.333,15,18,0.833,122,47,84,0.56,32,52,0.615,15,32,0.469,18,23,0.783,127
1057,2021/1/11,SAC,IND,W 127-122,240,47,84,0.56,32,52,0.615,15,32,0.469,18,23,0.783,127,47,97,0.485,34,58,0.586,13,39,0.333,15,18,0.833,122
1058,2021/1/11,PHO,WAS,L 107-128,240,39,87,0.448,35,60,0.583,4,27,0.148,25,30,0.833,107,48,92,0.522,33,58,0.569,15,34,0.441,17,28,0.607,128
1059,2021/1/11,WAS,PHO,W 128-107,240,48,92,0.522,33,58,0.569,15,34,0.441,17,28,0.607,128,39,87,0.448,35,60,0.583,4,27,0.148,25,30,0.833,107
1060,2021/1/10,BRK,OKC,L 116-129,240,43,85,0.506,33,51,0.647,10,34,0.294,20,24,0.833,116,49,90,0.544,34,51,0.667,15,39,0.385,16,17,0.941,129
1061,2021/1/10,OKC,BRK,W 129-116,240,49,90,0.544,34,51,0.667,15,39,0.385,16,17,0.941,129,43,85,0.506,33,51,0.647,10,34,0.294,20,24,0.833,116
1062,2021/1/10,DET,UTA,L 86-96,240,29,87,0.333,19,45,0.422,10,42,0.238,18,21,0.857,86,35,82,0.427,24,47,0.511,11,35,0.314,15,22,0.682,96
1063,2021/1/10,UTA,DET,W 96-86,240,35,82,0.427,24,47,0.511,11,35,0.314,15,22,0.682,96,29,87,0.333,19,45,0.422,10,42,0.238,18,21,0.857,86
1064,2021/1/10,GSW,TOR,W 106-105,240,38,93,0.409,25,47,0.532,13,46,0.283,17,19,0.895,106,39,96,0.406,26,58,0.448,13,38,0.342,14,22,0.636,105
1065,2021/1/10,TOR,GSW,L 105-106,240,39,96,0.406,26,58,0.448,13,38,0.342,14,22,0.636,105,38,93,0.409,25,47,0.532,13,46,0.283,17,19,0.895,106
1066,2021/1/10,HOU,LAL,L 102-120,240,37,90,0.411,25,49,0.51,12,41,0.293,16,23,0.696,102,46,91,0.505,36,62,0.581,10,29,0.345,18,24,0.75,120
1067,2021/1/10,LAL,HOU,W 120-102,240,46,91,0.505,36,62,0.581,10,29,0.345,18,24,0.75,120,37,90,0.411,25,49,0.51,12,41,0.293,16,23,0.696,102
1068,2021/1/10,CHI,LAC,L 127-130,240,47,77,0.61,29,44,0.659,18,33,0.545,15,17,0.882,127,45,92,0.489,25,54,0.463,20,38,0.526,20,25,0.8,130
1069,2021/1/10,LAC,CHI,W 130-127,240,45,92,0.489,25,54,0.463,20,38,0.526,20,25,0.8,130,47,77,0.61,29,44,0.659,18,33,0.545,15,17,0.882,127
1070,2021/1/10,MIN,SAS,W 96-88,240,34,81,0.42,25,55,0.455,9,26,0.346,19,23,0.826,96,36,94,0.383,28,64,0.438,8,30,0.267,8,14,0.571,88
1071,2021/1/10,SAS,MIN,L 88-96,240,36,94,0.383,28,64,0.438,8,30,0.267,8,14,0.571,88,34,81,0.42,25,55,0.455,9,26,0.346,19,23,0.826,96
1072,2021/1/10,DEN,NYK,W 114-89,240,45,84,0.536,30,49,0.612,15,35,0.429,9,12,0.75,114,32,74,0.432,26,53,0.491,6,21,0.286,19,25,0.76,89
1073,2021/1/10,NYK,DEN,L 89-114,240,32,74,0.432,26,53,0.491,6,21,0.286,19,25,0.76,89,45,84,0.536,30,49,0.612,15,35,0.429,9,12,0.75,114
1074,2021/1/9,ATL,CHO,L 105-113,240,34,89,0.382,20,44,0.455,14,45,0.311,23,28,0.821,105,40,77,0.519,25,44,0.568,15,33,0.455,18,24,0.75,113
1075,2021/1/9,CHO,ATL,W 113-105,240,40,77,0.519,25,44,0.568,15,33,0.455,18,24,0.75,113,34,89,0.382,20,44,0.455,14,45,0.311,23,28,0.821,105
1076,2021/1/9,DAL,ORL,W 112-98,240,39,79,0.494,19,39,0.487,20,40,0.5,14,18,0.778,112,38,89,0.427,32,58,0.552,6,31,0.194,16,22,0.727,98
1077,2021/1/9,ORL,DAL,L 98-112,240,38,89,0.427,32,58,0.552,6,31,0.194,16,22,0.727,98,39,79,0.494,19,39,0.487,20,40,0.5,14,18,0.778,112
1078,2021/1/9,IND,PHO,L 117-125,240,44,92,0.478,32,63,0.508,12,29,0.414,17,24,0.708,117,46,94,0.489,30,53,0.566,16,41,0.39,17,17,1,125
1079,2021/1/9,PHO,IND,W 125-117,240,46,94,0.489,30,53,0.566,16,41,0.39,17,17,1,125,44,92,0.478,32,63,0.508,12,29,0.414,17,24,0.708,117
1080,2021/1/9,CLE,MIL,L 90-100,240,36,87,0.414,29,61,0.475,7,26,0.269,11,16,0.688,90,37,84,0.44,25,48,0.521,12,36,0.333,14,18,0.778,100
1081,2021/1/9,MIL,CLE,W 100-90,240,37,84,0.44,25,48,0.521,12,36,0.333,14,18,0.778,100,36,87,0.414,29,61,0.475,7,26,0.269,11,16,0.688,90
1082,2021/1/9,MIN,SAS,L 122-125 (OT),265,48,96,0.5,33,66,0.5,15,30,0.5,11,17,0.647,122,44,101,0.436,31,69,0.449,13,32,0.406,24,29,0.828,125
1083,2021/1/9,SAS,MIN,W 125-122 (OT),265,44,101,0.436,31,69,0.449,13,32,0.406,24,29,0.828,125,48,96,0.5,33,66,0.5,15,30,0.5,11,17,0.647,122
1084,2021/1/9,DEN,PHI,W 115-103,240,45,90,0.5,33,57,0.579,12,33,0.364,13,15,0.867,115,43,103,0.417,32,68,0.471,11,35,0.314,6,10,0.6,103
1085,2021/1/9,PHI,DEN,L 103-115,240,43,103,0.417,32,68,0.471,11,35,0.314,6,10,0.6,103,45,90,0.5,33,57,0.579,12,33,0.364,13,15,0.867,115
1086,2021/1/9,POR,SAC,W 125-99,240,44,100,0.44,27,59,0.458,17,41,0.415,20,23,0.87,125,33,81,0.407,25,51,0.49,8,30,0.267,25,35,0.714,99
1087,2021/1/9,SAC,POR,L 99-125,240,33,81,0.407,25,51,0.49,8,30,0.267,25,35,0.714,99,44,100,0.44,27,59,0.458,17,41,0.415,20,23,0.87,125
1088,2021/1/9,MIA,WAS,W 128-124,240,46,93,0.495,30,50,0.6,16,43,0.372,20,26,0.769,128,44,99,0.444,29,59,0.492,15,40,0.375,21,28,0.75,124
1089,2021/1/9,WAS,MIA,L 124-128,240,44,99,0.444,29,59,0.492,15,40,0.375,21,28,0.75,124,46,93,0.495,30,50,0.6,16,43,0.372,20,26,0.769,128
1090,2021/1/8,BOS,WAS,W 116-107,240,41,86,0.477,29,54,0.537,12,32,0.375,22,30,0.733,116,41,88,0.466,30,59,0.508,11,29,0.379,14,16,0.875,107
1091,2021/1/8,WAS,BOS,L 107-116,240,41,88,0.466,30,59,0.508,11,29,0.379,14,16,0.875,107,41,86,0.477,29,54,0.537,12,32,0.375,22,30,0.733,116
1092,2021/1/8,DET,PHO,W 110-105 (OT),265,37,90,0.411,26,56,0.464,11,34,0.324,25,29,0.862,110,41,91,0.451,24,39,0.615,17,52,0.327,6,13,0.462,105
1093,2021/1/8,PHO,DET,L 105-110 (OT),265,41,91,0.451,24,39,0.615,17,52,0.327,6,13,0.462,105,37,90,0.411,26,56,0.464,11,34,0.324,25,29,0.862,110
1094,2021/1/8,GSW,LAC,W 115-105,240,40,82,0.488,20,41,0.488,20,41,0.488,15,18,0.833,115,40,83,0.482,26,52,0.5,14,31,0.452,11,13,0.846,105
1095,2021/1/8,LAC,GSW,L 105-115,240,40,83,0.482,26,52,0.5,14,31,0.452,11,13,0.846,105,40,82,0.488,20,41,0.488,20,41,0.488,15,18,0.833,115
1096,2021/1/8,HOU,ORL,W 132-90,240,51,91,0.56,29,44,0.659,22,47,0.468,8,11,0.727,132,34,89,0.382,26,60,0.433,8,29,0.276,14,16,0.875,90
1097,2021/1/8,ORL,HOU,L 90-132,240,34,89,0.382,26,60,0.433,8,29,0.276,14,16,0.875,90,51,91,0.56,29,44,0.659,22,47,0.468,8,11,0.727,132
1098,2021/1/8,CHI,LAL,L 115-117,240,46,91,0.505,36,65,0.554,10,26,0.385,13,14,0.929,115,41,81,0.506,29,52,0.558,12,29,0.414,23,27,0.852,117
1099,2021/1/8,LAL,CHI,W 117-115,240,41,81,0.506,29,52,0.558,12,29,0.414,23,27,0.852,117,46,91,0.505,36,65,0.554,10,26,0.385,13,14,0.929,115
1100,2021/1/8,BRK,MEM,L 110-115,240,38,81,0.469,24,50,0.48,14,31,0.452,20,21,0.952,110,45,98,0.459,32,66,0.485,13,32,0.406,12,14,0.857,115
1101,2021/1/8,MEM,BRK,W 115-110,240,45,98,0.459,32,66,0.485,13,32,0.406,12,14,0.857,115,38,81,0.469,24,50,0.48,14,31,0.452,20,21,0.952,110
1102,2021/1/8,MIL,UTA,L 118-131,240,44,98,0.449,31,56,0.554,13,42,0.31,17,21,0.81,118,49,97,0.505,24,44,0.545,25,53,0.472,8,13,0.615,131
1103,2021/1/8,UTA,MIL,W 131-118,240,49,97,0.505,24,44,0.545,25,53,0.472,8,13,0.615,131,44,98,0.449,31,56,0.554,13,42,0.31,17,21,0.81,118
1104,2021/1/8,CHO,NOP,W 118-110,240,41,87,0.471,25,45,0.556,16,42,0.381,20,25,0.8,118,38,77,0.494,23,39,0.59,15,38,0.395,19,26,0.731,110
1105,2021/1/8,NOP,CHO,L 110-118,240,38,77,0.494,23,39,0.59,15,38,0.395,19,26,0.731,110,41,87,0.471,25,45,0.556,16,42,0.381,20,25,0.8,118
1106,2021/1/8,NYK,OKC,L 89-101,240,34,96,0.354,25,69,0.362,9,27,0.333,12,20,0.6,89,38,87,0.437,27,53,0.509,11,34,0.324,14,21,0.667,101
1107,2021/1/8,OKC,NYK,W 101-89,240,38,87,0.437,27,53,0.509,11,34,0.324,14,21,0.667,101,34,96,0.354,25,69,0.362,9,27,0.333,12,20,0.6,89
1108,2021/1/8,SAC,TOR,L 123-144,240,46,81,0.568,31,47,0.66,15,34,0.441,16,28,0.571,123,53,91,0.582,33,52,0.635,20,39,0.513,18,22,0.818,144
1109,2021/1/8,TOR,SAC,W 144-123,240,53,91,0.582,33,52,0.635,20,39,0.513,18,22,0.818,144,46,81,0.568,31,47,0.66,15,34,0.441,16,28,0.571,123
1110,2021/1/7,BRK,PHI,W 122-109,240,44,97,0.454,29,60,0.483,15,37,0.405,19,29,0.655,122,41,87,0.471,32,61,0.525,9,26,0.346,18,20,0.9,109
1111,2021/1/7,PHI,BRK,L 109-122,240,41,87,0.471,32,61,0.525,9,26,0.346,18,20,0.9,109,44,97,0.454,29,60,0.483,15,37,0.405,19,29,0.655,122
1112,2021/1/7,DAL,DEN,W 124-117 (OT),265,42,87,0.483,26,47,0.553,16,40,0.4,24,31,0.774,124,43,97,0.443,28,53,0.528,15,44,0.341,16,21,0.762,117
1113,2021/1/7,DEN,DAL,L 117-124 (OT),265,43,97,0.443,28,53,0.528,15,44,0.341,16,21,0.762,117,42,87,0.483,26,47,0.553,16,40,0.4,24,31,0.774,124
1114,2021/1/7,LAL,SAS,L 109-118,240,43,86,0.5,33,56,0.589,10,30,0.333,13,21,0.619,109,43,92,0.467,27,57,0.474,16,35,0.457,16,17,0.941,118
1115,2021/1/7,SAS,LAL,W 118-109,240,43,92,0.467,27,57,0.474,16,35,0.457,16,17,0.941,118,43,86,0.5,33,56,0.589,10,30,0.333,13,21,0.619,109
1116,2021/1/7,CLE,MEM,W 94-90,240,36,79,0.456,23,49,0.469,13,30,0.433,9,16,0.563,94,36,83,0.434,25,52,0.481,11,31,0.355,7,8,0.875,90
1117,2021/1/7,MEM,CLE,L 90-94,240,36,83,0.434,25,52,0.481,11,31,0.355,7,8,0.875,90,36,79,0.456,23,49,0.469,13,30,0.433,9,16,0.563,94
1118,2021/1/7,MIN,POR,L 117-135,240,39,93,0.419,25,52,0.481,14,41,0.341,25,33,0.758,117,49,90,0.544,31,49,0.633,18,41,0.439,19,23,0.826,135
1119,2021/1/7,POR,MIN,W 135-117,240,49,90,0.544,31,49,0.633,18,41,0.439,19,23,0.826,135,39,93,0.419,25,52,0.481,14,41,0.341,25,33,0.758,117
1120,2021/1/6,ATL,CHO,L 94-102,240,36,96,0.375,29,56,0.518,7,40,0.175,15,18,0.833,94,32,85,0.376,21,49,0.429,11,36,0.306,27,33,0.818,102
1121,2021/1/6,CHO,ATL,W 102-94,240,32,85,0.376,21,49,0.429,11,36,0.306,27,33,0.818,102,36,96,0.375,29,56,0.518,7,40,0.175,15,18,0.833,94
1122,2021/1/6,GSW,LAC,L 101-108,240,39,86,0.453,31,56,0.554,8,30,0.267,15,19,0.789,101,36,81,0.444,25,47,0.532,11,34,0.324,25,25,1,108
1123,2021/1/6,LAC,GSW,W 108-101,240,36,81,0.444,25,47,0.532,11,34,0.324,25,25,1,108,39,86,0.453,31,56,0.554,8,30,0.267,15,19,0.789,101
1124,2021/1/6,HOU,IND,L 107-114,240,39,81,0.481,31,51,0.608,8,30,0.267,21,26,0.808,107,42,89,0.472,33,66,0.5,9,23,0.391,21,26,0.808,114
1125,2021/1/6,IND,HOU,W 114-107,240,42,89,0.472,33,66,0.5,9,23,0.391,21,26,0.808,114,39,81,0.481,31,51,0.608,8,30,0.267,21,26,0.808,107
1126,2021/1/6,BOS,MIA,W 107-105,240,42,99,0.424,30,64,0.469,12,35,0.343,11,12,0.917,107,35,81,0.432,22,45,0.489,13,36,0.361,22,26,0.846,105
1127,2021/1/6,MIA,BOS,L 105-107,240,35,81,0.432,22,45,0.489,13,36,0.361,22,26,0.846,105,42,99,0.424,30,64,0.469,12,35,0.343,11,12,0.917,107
1128,2021/1/6,DET,MIL,L 115-130,240,38,97,0.392,25,56,0.446,13,41,0.317,26,30,0.867,115,49,90,0.544,30,47,0.638,19,43,0.442,13,21,0.619,130
1129,2021/1/6,MIL,DET,W 130-115,240,49,90,0.544,30,47,0.638,19,43,0.442,13,21,0.619,130,38,97,0.392,25,56,0.446,13,41,0.317,26,30,0.867,115
1130,2021/1/6,NOP,OKC,L 110-111,240,44,89,0.494,40,67,0.597,4,22,0.182,18,23,0.783,110,40,87,0.46,21,41,0.512,19,46,0.413,12,16,0.75,111
1131,2021/1/6,OKC,NOP,W 111-110,240,40,87,0.46,21,41,0.512,19,46,0.413,12,16,0.75,111,44,89,0.494,40,67,0.597,4,22,0.182,18,23,0.783,110
1132,2021/1/6,NYK,UTA,W 112-100,240,45,87,0.517,37,65,0.569,8,22,0.364,14,19,0.737,112,40,91,0.44,26,47,0.553,14,44,0.318,6,11,0.545,100
1133,2021/1/6,UTA,NYK,L 100-112,240,40,91,0.44,26,47,0.553,14,44,0.318,6,11,0.545,100,45,87,0.517,37,65,0.569,8,22,0.364,14,19,0.737,112
1134,2021/1/6,CLE,ORL,L 94-105,240,36,85,0.424,32,59,0.542,4,26,0.154,18,26,0.692,94,40,81,0.494,28,52,0.538,12,29,0.414,13,18,0.722,105
1135,2021/1/6,ORL,CLE,W 105-94,240,40,81,0.494,28,52,0.538,12,29,0.414,13,18,0.722,105,36,85,0.424,32,59,0.542,4,26,0.154,18,26,0.692,94
1136,2021/1/6,PHI,WAS,W 141-136,240,50,81,0.617,32,52,0.615,18,29,0.621,23,33,0.697,141,47,94,0.5,31,57,0.544,16,37,0.432,26,35,0.743,136
1137,2021/1/6,WAS,PHI,L 136-141,240,47,94,0.5,31,57,0.544,16,37,0.432,26,35,0.743,136,50,81,0.617,32,52,0.615,18,29,0.621,23,33,0.697,141
1138,2021/1/6,PHO,TOR,W 123-115,240,40,83,0.482,19,43,0.442,21,40,0.525,22,24,0.917,123,39,79,0.494,25,44,0.568,14,35,0.4,23,32,0.719,115
1139,2021/1/6,TOR,PHO,L 115-123,240,39,79,0.494,25,44,0.568,14,35,0.4,23,32,0.719,115,40,83,0.482,19,43,0.442,21,40,0.525,22,24,0.917,123
1140,2021/1/6,CHI,SAC,L 124-128,240,49,93,0.527,35,53,0.66,14,40,0.35,12,15,0.8,124,47,91,0.516,33,54,0.611,14,37,0.378,20,27,0.741,128
1141,2021/1/6,SAC,CHI,W 128-124,240,47,91,0.516,33,54,0.611,14,37,0.378,20,27,0.741,128,49,93,0.527,35,53,0.66,14,40,0.35,12,15,0.8,124
1142,2021/1/5,BRK,UTA,W 130-96,240,52,93,0.559,38,57,0.667,14,36,0.389,12,16,0.75,130,33,86,0.384,22,52,0.423,11,34,0.324,19,27,0.704,96
1143,2021/1/5,UTA,BRK,L 96-130,240,33,86,0.384,22,52,0.423,11,34,0.324,19,27,0.704,96,52,93,0.559,38,57,0.667,14,36,0.389,12,16,0.75,130
1144,2021/1/5,DEN,MIN,W 123-116,240,41,79,0.519,33,54,0.611,8,25,0.32,33,45,0.733,123,42,91,0.462,31,57,0.544,11,34,0.324,21,27,0.778,116
1145,2021/1/5,MIN,DEN,L 116-123,240,42,91,0.462,31,57,0.544,11,34,0.324,21,27,0.778,116,41,79,0.519,33,54,0.611,8,25,0.32,33,45,0.733,123
1146,2021/1/5,LAC,SAS,L 113-116,240,43,86,0.5,28,51,0.549,15,35,0.429,12,13,0.923,113,44,96,0.458,24,56,0.429,20,40,0.5,8,11,0.727,116
1147,2021/1/5,SAS,LAC,W 116-113,240,44,96,0.458,24,56,0.429,20,40,0.5,8,11,0.727,116,43,86,0.5,28,51,0.549,15,35,0.429,12,13,0.923,113
1148,2021/1/5,LAL,MEM,W 94-92,240,38,87,0.437,29,56,0.518,9,31,0.29,9,11,0.818,94,36,87,0.414,26,61,0.426,10,26,0.385,10,13,0.769,92
1149,2021/1/5,MEM,LAL,L 92-94,240,36,87,0.414,26,61,0.426,10,26,0.385,10,13,0.769,92,38,87,0.437,29,56,0.518,9,31,0.29,9,11,0.818,94
1150,2021/1/5,CHI,POR,W 111-108,240,40,91,0.44,24,50,0.48,16,41,0.39,15,18,0.833,111,39,94,0.415,20,43,0.465,19,51,0.373,11,17,0.647,108
1151,2021/1/5,POR,CHI,L 108-111,240,39,94,0.415,20,43,0.465,19,51,0.373,11,17,0.647,108,40,91,0.44,24,50,0.48,16,41,0.39,15,18,0.833,111
1152,2021/1/4,ATL,NYK,L 108-113,240,40,87,0.46,30,56,0.536,10,31,0.323,18,23,0.783,108,43,85,0.506,36,64,0.563,7,21,0.333,20,25,0.8,113
1153,2021/1/4,NYK,ATL,W 113-108,240,43,85,0.506,36,64,0.563,7,21,0.333,20,25,0.8,113,40,87,0.46,30,56,0.536,10,31,0.323,18,23,0.783,108
1154,2021/1/4,GSW,SAC,W 137-106,240,51,97,0.526,28,54,0.519,23,43,0.535,12,14,0.857,137,34,90,0.378,24,55,0.436,10,35,0.286,28,39,0.718,106
1155,2021/1/4,SAC,GSW,L 106-137,240,34,90,0.378,24,55,0.436,10,35,0.286,28,39,0.718,106,51,97,0.526,28,54,0.519,23,43,0.535,12,14,0.857,137
1156,2021/1/4,DAL,HOU,W 113-100,240,39,82,0.476,23,43,0.535,16,39,0.41,19,20,0.95,113,30,77,0.39,19,37,0.514,11,40,0.275,29,36,0.806,100
1157,2021/1/4,HOU,DAL,L 100-113,240,30,77,0.39,19,37,0.514,11,40,0.275,29,36,0.806,100,39,82,0.476,23,43,0.535,16,39,0.41,19,20,0.95,113
1158,2021/1/4,MIA,OKC,W 118-90,240,46,81,0.568,30,47,0.638,16,34,0.471,10,18,0.556,118,29,79,0.367,16,31,0.516,13,48,0.271,19,27,0.704,90
1159,2021/1/4,OKC,MIA,L 90-118,240,29,79,0.367,16,31,0.516,13,48,0.271,19,27,0.704,90,46,81,0.568,30,47,0.638,16,34,0.471,10,18,0.556,118
1160,2021/1/4,DET,MIL,L 115-125,240,43,98,0.439,26,58,0.448,17,40,0.425,12,12,1,115,49,85,0.576,35,51,0.686,14,34,0.412,13,16,0.813,125
1161,2021/1/4,MIL,DET,W 125-115,240,49,85,0.576,35,51,0.686,14,34,0.412,13,16,0.813,125,43,98,0.439,26,58,0.448,17,40,0.425,12,12,1,115
1162,2021/1/4,IND,NOP,W 118-116 (OT),265,45,93,0.484,26,48,0.542,19,45,0.422,9,13,0.692,118,44,101,0.436,35,74,0.473,9,27,0.333,19,24,0.792,116
1163,2021/1/4,NOP,IND,L 116-118 (OT),265,44,101,0.436,35,74,0.473,9,27,0.333,19,24,0.792,116,45,93,0.484,26,48,0.542,19,45,0.422,9,13,0.692,118
1164,2021/1/4,CLE,ORL,L 83-103,240,33,85,0.388,23,57,0.404,10,28,0.357,7,12,0.583,83,38,88,0.432,23,54,0.426,15,34,0.441,12,13,0.923,103
1165,2021/1/4,ORL,CLE,W 103-83,240,38,88,0.432,23,54,0.426,15,34,0.441,12,13,0.923,103,33,85,0.388,23,57,0.404,10,28,0.357,7,12,0.583,83
1166,2021/1/4,CHO,PHI,L 101-118,240,36,86,0.419,23,47,0.489,13,39,0.333,16,22,0.727,101,46,95,0.484,35,63,0.556,11,32,0.344,15,23,0.652,118
1167,2021/1/4,PHI,CHO,W 118-101,240,46,95,0.484,35,63,0.556,11,32,0.344,15,23,0.652,118,36,86,0.419,23,47,0.489,13,39,0.333,16,22,0.727,101
1168,2021/1/4,BOS,TOR,W 126-114,240,41,84,0.488,26,55,0.473,15,29,0.517,29,34,0.853,126,36,90,0.4,23,53,0.434,13,37,0.351,29,38,0.763,114
1169,2021/1/4,TOR,BOS,L 114-126,240,36,90,0.4,23,53,0.434,13,37,0.351,29,38,0.763,114,41,84,0.488,26,55,0.473,15,29,0.517,29,34,0.853,126
1170,2021/1/3,BRK,WAS,L 122-123,240,40,81,0.494,26,49,0.531,14,32,0.438,28,31,0.903,122,43,104,0.413,31,71,0.437,12,33,0.364,25,34,0.735,123
1171,2021/1/3,WAS,BRK,W 123-122,240,43,104,0.413,31,71,0.437,12,33,0.364,25,34,0.735,123,40,81,0.494,26,49,0.531,14,32,0.438,28,31,0.903,122
1172,2021/1/3,CHI,DAL,W 118-108,240,39,85,0.459,26,48,0.542,13,37,0.351,27,30,0.9,118,39,89,0.438,28,47,0.596,11,42,0.262,19,27,0.704,108
1173,2021/1/3,DAL,CHI,L 108-118,240,39,89,0.438,28,47,0.596,11,42,0.262,19,27,0.704,108,39,85,0.459,26,48,0.542,13,37,0.351,27,30,0.9,118
1174,2021/1/3,BOS,DET,W 122-120,240,49,87,0.563,34,54,0.63,15,33,0.455,9,13,0.692,122,41,86,0.477,25,50,0.5,16,36,0.444,22,25,0.88,120
1175,2021/1/3,DET,BOS,L 120-122,240,41,86,0.477,25,50,0.5,16,36,0.444,22,25,0.88,120,49,87,0.563,34,54,0.63,15,33,0.455,9,13,0.692,122
1176,2021/1/3,GSW,POR,W 137-122,240,49,88,0.557,36,54,0.667,13,34,0.382,26,34,0.765,137,41,98,0.418,27,55,0.491,14,43,0.326,26,33,0.788,122
1177,2021/1/3,POR,GSW,L 122-137,240,41,98,0.418,27,55,0.491,14,43,0.326,26,33,0.788,122,49,88,0.557,36,54,0.667,13,34,0.382,26,34,0.765,137
1178,2021/1/3,LAL,MEM,W 108-94,240,41,89,0.461,29,54,0.537,12,35,0.343,14,19,0.737,108,39,95,0.411,30,62,0.484,9,33,0.273,7,8,0.875,94
1179,2021/1/3,MEM,LAL,L 94-108,240,39,95,0.411,30,62,0.484,9,33,0.273,7,8,0.875,94,41,89,0.461,29,54,0.537,12,35,0.343,14,19,0.737,108
1180,2021/1/3,DEN,MIN,W 124-109,240,45,92,0.489,26,47,0.553,19,45,0.422,15,21,0.714,124,44,85,0.518,34,54,0.63,10,31,0.323,11,16,0.688,109
1181,2021/1/3,MIN,DEN,L 109-124,240,44,85,0.518,34,54,0.63,10,31,0.323,11,16,0.688,109,45,92,0.489,26,47,0.553,19,45,0.422,15,21,0.714,124
1182,2021/1/3,LAC,PHO,W 112-107,240,40,83,0.482,23,54,0.426,17,29,0.586,15,19,0.789,112,37,75,0.493,27,42,0.643,10,33,0.303,23,28,0.821,107
1183,2021/1/3,PHO,LAC,L 107-112,240,37,75,0.493,27,42,0.643,10,33,0.303,23,28,0.821,107,40,83,0.482,23,54,0.426,17,29,0.586,15,19,0.789,112
1184,2021/1/3,SAS,UTA,L 109-130,240,44,105,0.419,38,86,0.442,6,19,0.316,15,21,0.714,109,49,89,0.551,28,48,0.583,21,41,0.512,11,19,0.579,130
1185,2021/1/3,UTA,SAS,W 130-109,240,49,89,0.551,28,48,0.583,21,41,0.512,11,19,0.579,130,44,105,0.419,38,86,0.442,6,19,0.316,15,21,0.714,109
1186,2021/1/2,ATL,CLE,L 91-96,240,35,85,0.412,24,53,0.453,11,32,0.344,10,19,0.526,91,38,91,0.418,31,62,0.5,7,29,0.241,13,17,0.765,96
1187,2021/1/2,CLE,ATL,W 96-91,240,38,91,0.418,31,62,0.5,7,29,0.241,13,17,0.765,96,35,85,0.412,24,53,0.453,11,32,0.344,10,19,0.526,91
1188,2021/1/2,HOU,SAC,W 102-94,240,36,81,0.444,23,40,0.575,13,41,0.317,17,23,0.739,102,35,90,0.389,26,62,0.419,9,28,0.321,15,21,0.714,94
1189,2021/1/2,SAC,HOU,L 94-102,240,35,90,0.389,26,62,0.419,9,28,0.321,15,21,0.714,94,36,81,0.444,23,40,0.575,13,41,0.317,17,23,0.739,102
1190,2021/1/2,IND,NYK,L 102-106,240,34,84,0.405,15,34,0.441,19,50,0.38,15,18,0.833,102,42,83,0.506,30,56,0.536,12,27,0.444,10,13,0.769,106
1191,2021/1/2,NYK,IND,W 106-102,240,42,83,0.506,30,56,0.536,12,27,0.444,10,13,0.769,106,34,84,0.405,15,34,0.441,19,50,0.38,15,18,0.833,102
1192,2021/1/2,NOP,TOR,W 120-116,240,35,83,0.422,21,45,0.467,14,38,0.368,36,47,0.766,120,38,91,0.418,24,43,0.558,14,48,0.292,26,27,0.963,116
1193,2021/1/2,TOR,NOP,L 116-120,240,38,91,0.418,24,43,0.558,14,48,0.292,26,27,0.963,116,35,83,0.422,21,45,0.467,14,38,0.368,36,47,0.766,120
1194,2021/1/2,OKC,ORL,W 108-99,240,38,86,0.442,25,45,0.556,13,41,0.317,19,21,0.905,108,40,108,0.37,30,70,0.429,10,38,0.263,9,12,0.75,99
1195,2021/1/2,ORL,OKC,L 99-108,240,40,108,0.37,30,70,0.429,10,38,0.263,9,12,0.75,99,38,86,0.442,25,45,0.556,13,41,0.317,19,21,0.905,108
1196,2021/1/2,CHO,PHI,L 112-127,240,38,92,0.413,25,57,0.439,13,35,0.371,23,26,0.885,112,47,79,0.595,31,44,0.705,16,35,0.457,17,24,0.708,127
1197,2021/1/2,PHI,CHO,W 127-112,240,47,79,0.595,31,44,0.705,16,35,0.457,17,24,0.708,127,38,92,0.413,25,57,0.439,13,35,0.371,23,26,0.885,112
1198,2021/1/1,ATL,BRK,W 114-96,240,43,93,0.462,27,54,0.5,16,39,0.41,12,14,0.857,114,35,86,0.407,28,49,0.571,7,37,0.189,19,23,0.826,96
1199,2021/1/1,BRK,ATL,L 96-114,240,35,86,0.407,28,49,0.571,7,37,0.189,19,23,0.826,96,43,93,0.462,27,54,0.5,16,39,0.41,12,14,0.857,114
1200,2021/1/1,CHO,MEM,L 93-108,240,35,86,0.407,26,55,0.473,9,31,0.29,14,21,0.667,93,43,90,0.478,29,51,0.569,14,39,0.359,8,10,0.8,108
1201,2021/1/1,MEM,CHO,W 108-93,240,43,90,0.478,29,51,0.569,14,39,0.359,8,10,0.8,108,35,86,0.407,26,55,0.473,9,31,0.29,14,21,0.667,93
1202,2021/1/1,DAL,MIA,W 93-83,240,32,78,0.41,20,41,0.488,12,37,0.324,17,23,0.739,93,29,78,0.372,22,45,0.489,7,33,0.212,18,25,0.72,83
1203,2021/1/1,MIA,DAL,L 83-93,240,29,78,0.372,22,45,0.489,7,33,0.212,18,25,0.72,83,32,78,0.41,20,41,0.488,12,37,0.324,17,23,0.739,93
1204,2021/1/1,DEN,PHO,L 103-106,240,39,86,0.453,27,57,0.474,12,29,0.414,13,16,0.813,103,37,76,0.487,24,41,0.585,13,35,0.371,19,21,0.905,106
1205,2021/1/1,PHO,DEN,W 106-103,240,37,76,0.487,24,41,0.585,13,35,0.371,19,21,0.905,106,39,86,0.453,27,57,0.474,12,29,0.414,13,16,0.813,103
1206,2021/1/1,BOS,DET,L 93-96,240,39,83,0.47,31,52,0.596,8,31,0.258,7,14,0.5,93,36,88,0.409,25,54,0.463,11,34,0.324,13,20,0.65,96
1207,2021/1/1,DET,BOS,W 96-93,240,36,88,0.409,25,54,0.463,11,34,0.324,13,20,0.65,96,39,83,0.47,31,52,0.596,8,31,0.258,7,14,0.5,93
1208,2021/1/1,GSW,POR,L 98-123,240,31,79,0.392,24,44,0.545,7,35,0.2,29,33,0.879,98,40,92,0.435,20,49,0.408,20,43,0.465,23,30,0.767,123
1209,2021/1/1,POR,GSW,W 123-98,240,40,92,0.435,20,49,0.408,20,43,0.465,23,30,0.767,123,31,79,0.392,24,44,0.545,7,35,0.2,29,33,0.879,98
1210,2021/1/1,CHI,MIL,L 96-126,240,38,87,0.437,32,61,0.525,6,26,0.231,14,20,0.7,96,42,85,0.494,20,40,0.5,22,45,0.489,20,30,0.667,126
1211,2021/1/1,MIL,CHI,W 126-96,240,42,85,0.494,20,40,0.5,22,45,0.489,20,30,0.667,126,38,87,0.437,32,61,0.525,6,26,0.231,14,20,0.7,96
1212,2021/1/1,MIN,WAS,L 109-130,240,42,88,0.477,29,52,0.558,13,36,0.361,12,21,0.571,109,49,89,0.551,33,56,0.589,16,33,0.485,16,21,0.762,130
1213,2021/1/1,WAS,MIN,W 130-109,240,49,89,0.551,33,56,0.589,16,33,0.485,16,21,0.762,130,42,88,0.477,29,52,0.558,13,36,0.361,12,21,0.571,109
1214,2021/1/1,LAL,SAS,W 109-103,240,41,101,0.406,27,68,0.397,14,33,0.424,13,16,0.813,109,36,85,0.424,23,51,0.451,13,34,0.382,18,26,0.692,103
1215,2021/1/1,SAS,LAL,L 103-109,240,36,85,0.424,23,51,0.451,13,34,0.382,18,26,0.692,103,41,101,0.406,27,68,0.397,14,33,0.424,13,16,0.813,109
1216,2021/1/1,LAC,UTA,L 100-106,240,33,85,0.388,20,52,0.385,13,33,0.394,21,24,0.875,100,41,89,0.461,26,47,0.553,15,42,0.357,9,14,0.643,106
1217,2021/1/1,UTA,LAC,W 106-100,240,41,89,0.461,26,47,0.553,15,42,0.357,9,14,0.643,106,33,85,0.388,20,52,0.385,13,33,0.394,21,24,0.875,100
1218,2020/12/31,HOU,SAC,W 122-119,240,45,86,0.523,32,50,0.64,13,36,0.361,19,25,0.76,122,45,96,0.469,34,63,0.54,11,33,0.333,18,24,0.75,119
1219,2020/12/31,SAC,HOU,L 119-122,240,45,96,0.469,34,63,0.54,11,33,0.333,18,24,0.75,119,45,86,0.523,32,50,0.64,13,36,0.361,19,25,0.76,122
1220,2020/12/31,CLE,IND,L 99-119,240,37,82,0.451,25,59,0.424,12,23,0.522,13,24,0.542,99,42,87,0.483,26,52,0.5,16,35,0.457,19,24,0.792,119
1221,2020/12/31,IND,CLE,W 119-99,240,42,87,0.483,26,52,0.5,16,35,0.457,19,24,0.792,119,37,82,0.451,25,59,0.424,12,23,0.522,13,24,0.542,99
1222,2020/12/31,NOP,OKC,W 113-80,240,44,91,0.484,31,55,0.564,13,36,0.361,12,19,0.632,113,30,80,0.375,15,32,0.469,15,48,0.313,5,15,0.333,80
1223,2020/12/31,OKC,NOP,L 80-113,240,30,80,0.375,15,32,0.469,15,48,0.313,5,15,0.333,80,44,91,0.484,31,55,0.564,13,36,0.361,12,19,0.632,113
1224,2020/12/31,ORL,PHI,L 92-116,240,33,95,0.347,26,67,0.388,7,28,0.25,19,21,0.905,92,44,91,0.484,29,58,0.5,15,33,0.455,13,15,0.867,116
1225,2020/12/31,PHI,ORL,W 116-92,240,44,91,0.484,29,58,0.5,15,33,0.455,13,15,0.867,116,33,95,0.347,26,67,0.388,7,28,0.25,19,21,0.905,92
1226,2020/12/31,NYK,TOR,L 83-100,240,32,88,0.364,29,52,0.558,3,36,0.083,16,20,0.8,83,34,83,0.41,17,31,0.548,17,52,0.327,15,21,0.714,100
1227,2020/12/31,TOR,NYK,W 100-83,240,34,83,0.41,17,31,0.548,17,52,0.327,15,21,0.714,100,32,88,0.364,29,52,0.558,3,36,0.083,16,20,0.8,83
1228,2020/12/31,PHO,UTA,W 106-95,240,41,84,0.488,24,51,0.471,17,33,0.515,7,10,0.7,106,35,84,0.417,23,50,0.46,12,34,0.353,13,19,0.684,95
1229,2020/12/31,UTA,PHO,L 95-106,240,35,84,0.417,23,50,0.46,12,34,0.353,13,19,0.684,95,41,84,0.488,24,51,0.471,17,33,0.515,7,10,0.7,106
1230,2020/12/31,CHI,WAS,W 133-130,240,50,92,0.543,36,56,0.643,14,36,0.389,19,25,0.76,133,42,84,0.5,28,55,0.509,14,29,0.483,32,41,0.78,130
1231,2020/12/31,WAS,CHI,L 130-133,240,42,84,0.5,28,55,0.509,14,29,0.483,32,41,0.78,130,50,92,0.543,36,56,0.643,14,36,0.389,19,25,0.76,133
1232,2020/12/30,BOS,MEM,W 126-107,240,49,91,0.538,33,52,0.635,16,39,0.41,12,14,0.857,126,40,93,0.43,31,60,0.517,9,33,0.273,18,25,0.72,107
1233,2020/12/30,MEM,BOS,L 107-126,240,40,93,0.43,31,60,0.517,9,33,0.273,18,25,0.72,107,49,91,0.538,33,52,0.635,16,39,0.41,12,14,0.857,126
1234,2020/12/30,ATL,BRK,L 141-145,240,47,99,0.475,29,53,0.547,18,46,0.391,29,35,0.829,141,54,100,0.54,35,59,0.593,19,41,0.463,18,23,0.783,145
1235,2020/12/30,BRK,ATL,W 145-141,240,54,100,0.54,35,59,0.593,19,41,0.463,18,23,0.783,145,47,99,0.475,29,53,0.547,18,46,0.391,29,35,0.829,141
1236,2020/12/30,CHO,DAL,W 118-99,240,43,84,0.512,28,50,0.56,15,34,0.441,17,21,0.81,118,34,87,0.391,22,45,0.489,12,42,0.286,19,33,0.576,99
1237,2020/12/30,DAL,CHO,L 99-118,240,34,87,0.391,22,45,0.489,12,42,0.286,19,33,0.576,99,43,84,0.512,28,50,0.56,15,34,0.441,17,21,0.81,118
1238,2020/12/30,LAC,POR,W 128-105,240,47,95,0.495,29,57,0.509,18,38,0.474,16,22,0.727,128,32,76,0.421,20,38,0.526,12,38,0.316,29,34,0.853,105
1239,2020/12/30,POR,LAC,L 105-128,240,32,76,0.421,20,38,0.526,12,38,0.316,29,34,0.853,105,47,95,0.495,29,57,0.509,18,38,0.474,16,22,0.727,128
1240,2020/12/30,MIA,MIL,W 119-108,240,40,82,0.488,25,43,0.581,15,39,0.385,24,29,0.828,119,40,102,0.392,24,61,0.393,16,41,0.39,12,13,0.923,108
1241,2020/12/30,MIL,MIA,L 108-119,240,40,102,0.392,24,61,0.393,16,41,0.39,12,13,0.923,108,40,82,0.488,25,43,0.581,15,39,0.385,24,29,0.828,119
1242,2020/12/30,LAL,SAS,W 121-107,240,46,82,0.561,32,56,0.571,14,26,0.538,15,20,0.75,121,40,87,0.46,30,63,0.476,10,24,0.417,17,23,0.739,107
1243,2020/12/30,SAS,LAL,L 107-121,240,40,87,0.46,30,63,0.476,10,24,0.417,17,23,0.739,107,46,82,0.561,32,56,0.571,14,26,0.538,15,20,0.75,121
1244,2020/12/29,CLE,NYK,L 86-95,240,32,88,0.364,25,56,0.446,7,32,0.219,15,22,0.682,86,34,79,0.43,20,54,0.37,14,25,0.56,13,21,0.619,95
1245,2020/12/29,NYK,CLE,W 95-86,240,34,79,0.43,20,54,0.37,14,25,0.56,13,21,0.619,95,32,88,0.364,25,56,0.446,7,32,0.219,15,22,0.682,86
1246,2020/12/29,DET,GSW,L 106-116,240,35,92,0.38,22,57,0.386,13,35,0.371,23,29,0.793,106,38,76,0.5,24,43,0.558,14,33,0.424,26,36,0.722,116
1247,2020/12/29,GSW,DET,W 116-106,240,38,76,0.5,24,43,0.558,14,33,0.424,26,36,0.722,116,35,92,0.38,22,57,0.386,13,35,0.371,23,29,0.793,106
1248,2020/12/29,BOS,IND,W 116-111,240,40,80,0.5,31,58,0.534,9,22,0.409,27,37,0.73,116,43,84,0.512,31,51,0.608,12,33,0.364,13,16,0.813,111
1249,2020/12/29,IND,BOS,L 111-116,240,43,84,0.512,31,51,0.608,12,33,0.364,13,16,0.813,111,40,80,0.5,31,58,0.534,9,22,0.409,27,37,0.73,116
1250,2020/12/29,LAC,MIN,W 124-101,240,47,88,0.534,31,57,0.544,16,31,0.516,14,16,0.875,124,37,89,0.416,24,51,0.471,13,38,0.342,14,17,0.824,101
1251,2020/12/29,MIN,LAC,L 101-124,240,37,89,0.416,24,51,0.471,13,38,0.342,14,17,0.824,101,47,88,0.534,31,57,0.544,16,31,0.516,14,16,0.875,124
1252,2020/12/29,MIA,MIL,L 97-144,240,37,79,0.468,26,42,0.619,11,37,0.297,12,18,0.667,97,51,92,0.554,22,41,0.537,29,51,0.569,13,15,0.867,144
1253,2020/12/29,MIL,MIA,W 144-97,240,51,92,0.554,22,41,0.537,29,51,0.569,13,15,0.867,144,37,79,0.468,26,42,0.619,11,37,0.297,12,18,0.667,97
1254,2020/12/29,OKC,ORL,L 107-118,240,43,87,0.494,32,53,0.604,11,34,0.324,10,19,0.526,107,49,96,0.51,42,74,0.568,7,22,0.318,13,16,0.813,118
1255,2020/12/29,ORL,OKC,W 118-107,240,49,96,0.51,42,74,0.568,7,22,0.318,13,16,0.813,118,43,87,0.494,32,53,0.604,11,34,0.324,10,19,0.526,107
1256,2020/12/29,PHI,TOR,W 100-93,240,32,84,0.381,24,53,0.453,8,31,0.258,28,33,0.848,100,32,90,0.356,15,45,0.333,17,45,0.378,12,14,0.857,93
1257,2020/12/29,TOR,PHI,L 93-100,240,32,90,0.356,15,45,0.333,17,45,0.378,12,14,0.857,93,32,84,0.381,24,53,0.453,8,31,0.258,28,33,0.848,100
1258,2020/12/29,NOP,PHO,L 86-111,240,37,77,0.481,34,53,0.642,3,24,0.125,9,18,0.5,86,37,84,0.44,18,37,0.486,19,47,0.404,18,19,0.947,111
1259,2020/12/29,PHO,NOP,W 111-86,240,37,84,0.44,18,37,0.486,19,47,0.404,18,19,0.947,111,37,77,0.481,34,53,0.642,3,24,0.125,9,18,0.5,86
1260,2020/12/29,DEN,SAC,L 115-125,240,44,81,0.543,33,53,0.623,11,28,0.393,16,20,0.8,115,46,94,0.489,30,61,0.492,16,33,0.485,17,22,0.773,125
1261,2020/12/29,SAC,DEN,W 125-115,240,46,94,0.489,30,61,0.492,16,33,0.485,17,22,0.773,125,44,81,0.543,33,53,0.623,11,28,0.393,16,20,0.8,115
1262,2020/12/29,CHI,WAS,W 115-107,240,38,87,0.437,23,51,0.451,15,36,0.417,24,32,0.75,115,37,84,0.44,27,47,0.574,10,37,0.27,23,26,0.885,107
1263,2020/12/29,WAS,CHI,L 107-115,240,37,84,0.44,27,47,0.574,10,37,0.27,23,26,0.885,107,38,87,0.437,23,51,0.451,15,36,0.417,24,32,0.75,115
1264,2020/12/28,ATL,DET,W 128-120,240,40,82,0.488,20,40,0.5,20,42,0.476,28,32,0.875,128,43,98,0.439,30,57,0.526,13,41,0.317,21,24,0.875,120
1265,2020/12/28,DET,ATL,L 120-128,240,43,98,0.439,30,57,0.526,13,41,0.317,21,24,0.875,120,40,82,0.488,20,40,0.5,20,42,0.476,28,32,0.875,128
1266,2020/12/28,BRK,MEM,L 111-116 (OT),265,41,100,0.41,27,58,0.466,14,42,0.333,15,17,0.882,111,42,98,0.429,32,69,0.464,10,29,0.345,22,29,0.759,116
1267,2020/12/28,MEM,BRK,W 116-111 (OT),265,42,98,0.429,32,69,0.464,10,29,0.345,22,29,0.759,116,41,100,0.41,27,58,0.466,14,42,0.333,15,17,0.882,111
1268,2020/12/28,DEN,HOU,W 124-111,240,46,87,0.529,32,56,0.571,14,31,0.452,18,32,0.563,124,39,86,0.453,23,47,0.489,16,39,0.41,17,23,0.739,111
1269,2020/12/28,HOU,DEN,L 111-124,240,39,86,0.453,23,47,0.489,16,39,0.41,17,23,0.739,111,46,87,0.529,32,56,0.571,14,31,0.452,18,32,0.563,124
1270,2020/12/28,LAL,POR,L 107-115,240,41,87,0.471,31,60,0.517,10,27,0.37,15,18,0.833,107,43,92,0.467,27,46,0.587,16,46,0.348,13,15,0.867,115
1271,2020/12/28,POR,LAL,W 115-107,240,43,92,0.467,27,46,0.587,16,46,0.348,13,15,0.867,115,41,87,0.471,31,60,0.517,10,27,0.37,15,18,0.833,107
1272,2020/12/28,OKC,UTA,L 109-110,240,40,86,0.465,25,48,0.521,15,38,0.395,14,19,0.737,109,43,86,0.5,30,50,0.6,13,36,0.361,11,14,0.786,110
1273,2020/12/28,UTA,OKC,W 110-109,240,43,86,0.5,30,50,0.6,13,36,0.361,11,14,0.786,110,40,86,0.465,25,48,0.521,15,38,0.395,14,19,0.737,109
1274,2020/12/27,CHI,GSW,L 128-129,240,44,86,0.512,27,45,0.6,17,41,0.415,23,31,0.742,128,42,104,0.404,24,57,0.421,18,47,0.383,27,30,0.9,129
1275,2020/12/27,GSW,CHI,W 129-128,240,42,104,0.404,24,57,0.421,18,47,0.383,27,30,0.9,129,44,86,0.512,27,45,0.6,17,41,0.415,23,31,0.742,128
1276,2020/12/27,BRK,CHO,L 104-106,240,35,82,0.427,18,35,0.514,17,47,0.362,17,25,0.68,104,43,96,0.448,33,62,0.532,10,34,0.294,10,17,0.588,106
1277,2020/12/27,CHO,BRK,W 106-104,240,43,96,0.448,33,62,0.532,10,34,0.294,10,17,0.588,106,35,82,0.427,18,35,0.514,17,47,0.362,17,25,0.68,104
1278,2020/12/27,CLE,PHI,W 118-94,240,48,91,0.527,39,68,0.574,9,23,0.391,13,16,0.813,118,33,79,0.418,21,42,0.5,12,37,0.324,16,22,0.727,94
1279,2020/12/27,PHI,CLE,L 94-118,240,33,79,0.418,21,42,0.5,12,37,0.324,16,22,0.727,94,48,91,0.527,39,68,0.574,9,23,0.391,13,16,0.813,118
1280,2020/12/27,BOS,IND,L 107-108,240,40,79,0.506,31,56,0.554,9,23,0.391,18,24,0.75,107,45,88,0.511,38,62,0.613,7,26,0.269,11,15,0.733,108
1281,2020/12/27,IND,BOS,W 108-107,240,45,88,0.511,38,62,0.613,7,26,0.269,11,15,0.733,108,40,79,0.506,31,56,0.554,9,23,0.391,18,24,0.75,107
1282,2020/12/27,DAL,LAC,W 124-73,240,43,87,0.494,29,46,0.63,14,41,0.341,24,27,0.889,124,26,76,0.342,22,43,0.512,4,33,0.121,17,20,0.85,73
1283,2020/12/27,LAC,DAL,L 73-124,240,26,76,0.342,22,43,0.512,4,33,0.121,17,20,0.85,73,43,87,0.494,29,46,0.63,14,41,0.341,24,27,0.889,124
1284,2020/12/27,LAL,MIN,W 127-91,240,50,90,0.556,37,55,0.673,13,35,0.371,14,18,0.778,127,38,103,0.369,32,68,0.471,6,35,0.171,9,14,0.643,91
1285,2020/12/27,MIN,LAL,L 91-127,240,38,103,0.369,32,68,0.471,6,35,0.171,9,14,0.643,91,50,90,0.556,37,55,0.673,13,35,0.371,14,18,0.778,127
1286,2020/12/27,NOP,SAS,W 98-95,240,36,94,0.383,31,70,0.443,5,24,0.208,21,29,0.724,98,38,89,0.427,27,53,0.509,11,36,0.306,8,8,1,95
1287,2020/12/27,SAS,NOP,L 95-98,240,38,89,0.427,27,53,0.509,11,36,0.306,8,8,1,95,36,94,0.383,31,70,0.443,5,24,0.208,21,29,0.724,98
1288,2020/12/27,MIL,NYK,L 110-130,240,41,95,0.432,34,57,0.596,7,38,0.184,21,29,0.724,110,46,85,0.541,30,58,0.517,16,27,0.593,22,27,0.815,130
1289,2020/12/27,NYK,MIL,W 130-110,240,46,85,0.541,30,58,0.517,16,27,0.593,22,27,0.815,130,41,95,0.432,34,57,0.596,7,38,0.184,21,29,0.724,110
1290,2020/12/27,PHO,SAC,W 116-100,240,46,94,0.489,32,59,0.542,14,35,0.4,10,11,0.909,116,36,76,0.474,26,53,0.491,10,23,0.435,18,25,0.72,100
1291,2020/12/27,SAC,PHO,L 100-116,240,36,76,0.474,26,53,0.491,10,23,0.435,18,25,0.72,100,46,94,0.489,32,59,0.542,14,35,0.4,10,11,0.909,116
1292,2020/12/27,ORL,WAS,W 120-113,240,37,85,0.435,28,60,0.467,9,25,0.36,37,38,0.974,120,47,97,0.485,39,65,0.6,8,32,0.25,11,13,0.846,113
1293,2020/12/27,WAS,ORL,L 113-120,240,47,97,0.485,39,65,0.6,8,32,0.25,11,13,0.846,113,37,85,0.435,28,60,0.467,9,25,0.36,37,38,0.974,120
1294,2020/12/26,CHI,IND,L 106-125,240,34,91,0.374,18,52,0.346,16,39,0.41,22,25,0.88,106,52,93,0.559,43,67,0.642,9,26,0.346,12,19,0.632,125
1295,2020/12/26,IND,CHI,W 125-106,240,52,93,0.559,43,67,0.642,9,26,0.346,12,19,0.632,125,34,91,0.374,18,52,0.346,16,39,0.41,22,25,0.88,106
1296,2020/12/26,CHO,OKC,L 107-109,240,37,93,0.398,24,61,0.393,13,32,0.406,20,32,0.625,107,40,88,0.455,30,52,0.577,10,36,0.278,19,24,0.792,109
1297,2020/12/26,OKC,CHO,W 109-107,240,40,88,0.455,30,52,0.577,10,36,0.278,19,24,0.792,109,37,93,0.398,24,61,0.393,13,32,0.406,20,32,0.625,107
1298,2020/12/26,CLE,DET,W 128-119 (2OT),290,48,99,0.485,35,69,0.507,13,30,0.433,19,30,0.633,128,40,98,0.408,24,53,0.453,16,45,0.356,23,32,0.719,119
1299,2020/12/26,DET,CLE,L 119-128 (2OT),290,40,98,0.408,24,53,0.453,16,45,0.356,23,32,0.719,119,48,99,0.485,35,69,0.507,13,30,0.433,19,30,0.633,128
1300,2020/12/26,ATL,MEM,W 122-112,240,38,89,0.427,25,53,0.472,13,36,0.361,33,38,0.868,122,37,93,0.398,24,50,0.48,13,43,0.302,25,29,0.862,112
1301,2020/12/26,MEM,ATL,L 112-122,240,37,93,0.398,24,50,0.48,13,43,0.302,25,29,0.862,112,38,89,0.427,25,53,0.472,13,36,0.361,33,38,0.868,122
1302,2020/12/26,NYK,PHI,L 89-109,240,32,83,0.386,24,54,0.444,8,29,0.276,17,23,0.739,89,41,88,0.466,30,57,0.526,11,31,0.355,16,22,0.727,109
1303,2020/12/26,PHI,NYK,W 109-89,240,41,88,0.466,30,57,0.526,11,31,0.355,16,22,0.727,109,32,83,0.386,24,54,0.444,8,29,0.276,17,23,0.739,89
1304,2020/12/26,HOU,POR,L 126-128 (OT),265,45,87,0.517,34,52,0.654,11,35,0.314,25,32,0.781,126,47,102,0.461,28,57,0.491,19,45,0.422,15,23,0.652,128
1305,2020/12/26,POR,HOU,W 128-126 (OT),265,47,102,0.461,28,57,0.491,19,45,0.422,15,23,0.652,128,45,87,0.517,34,52,0.654,11,35,0.314,25,32,0.781,126
1306,2020/12/26,PHO,SAC,L 103-106,240,41,98,0.418,30,54,0.556,11,44,0.25,10,13,0.769,103,39,86,0.453,34,63,0.54,5,23,0.217,23,33,0.697,106
1307,2020/12/26,SAC,PHO,W 106-103,240,39,86,0.453,34,63,0.54,5,23,0.217,23,33,0.697,106,41,98,0.418,30,54,0.556,11,44,0.25,10,13,0.769,103
1308,2020/12/26,SAS,TOR,W 119-114,240,47,100,0.47,33,66,0.5,14,34,0.412,11,16,0.688,119,44,96,0.458,29,55,0.527,15,41,0.366,11,15,0.733,114
1309,2020/12/26,TOR,SAS,L 114-119,240,44,96,0.458,29,55,0.527,15,41,0.366,11,15,0.733,114,47,100,0.47,33,66,0.5,14,34,0.412,11,16,0.688,119
1310,2020/12/26,MIN,UTA,W 116-111,240,45,101,0.446,32,72,0.444,13,29,0.448,13,18,0.722,116,36,94,0.383,26,60,0.433,10,34,0.294,29,37,0.784,111
1311,2020/12/26,UTA,MIN,L 111-116,240,36,94,0.383,26,60,0.433,10,34,0.294,29,37,0.784,111,45,101,0.446,32,72,0.444,13,29,0.448,13,18,0.722,116
1312,2020/12/26,ORL,WAS,W 130-120,240,48,95,0.505,37,64,0.578,11,31,0.355,23,29,0.793,130,46,95,0.484,33,58,0.569,13,37,0.351,15,28,0.536,120
1313,2020/12/26,WAS,ORL,L 120-130,240,46,95,0.484,33,58,0.569,13,37,0.351,15,28,0.536,120,48,95,0.505,37,64,0.578,11,31,0.355,23,29,0.793,130
1314,2020/12/25,BOS,BRK,L 95-123,240,37,98,0.378,29,71,0.408,8,27,0.296,13,19,0.684,95,41,76,0.539,26,47,0.553,15,29,0.517,26,31,0.839,123
1315,2020/12/25,BRK,BOS,W 123-95,240,41,76,0.539,26,47,0.553,15,29,0.517,26,31,0.839,123,37,98,0.378,29,71,0.408,8,27,0.296,13,19,0.684,95
1316,2020/12/25,DEN,LAC,L 108-121,240,37,81,0.457,26,45,0.578,11,36,0.306,23,31,0.742,108,41,74,0.554,22,36,0.611,19,38,0.5,20,24,0.833,121
1317,2020/12/25,LAC,DEN,W 121-108,240,41,74,0.554,22,36,0.611,19,38,0.5,20,24,0.833,121,37,81,0.457,26,45,0.578,11,36,0.306,23,31,0.742,108
1318,2020/12/25,DAL,LAL,L 115-138,240,41,83,0.494,28,51,0.549,13,32,0.406,20,26,0.769,115,51,91,0.56,32,52,0.615,19,39,0.487,17,24,0.708,138
1319,2020/12/25,LAL,DAL,W 138-115,240,51,91,0.56,32,52,0.615,19,39,0.487,17,24,0.708,138,41,83,0.494,28,51,0.549,13,32,0.406,20,26,0.769,115
1320,2020/12/25,MIA,NOP,W 111-98,240,38,75,0.507,22,38,0.579,16,37,0.432,19,23,0.826,111,31,78,0.397,21,43,0.488,10,35,0.286,26,33,0.788,98
1321,2020/12/25,NOP,MIA,L 98-111,240,31,78,0.397,21,43,0.488,10,35,0.286,26,33,0.788,98,38,75,0.507,22,38,0.579,16,37,0.432,19,23,0.826,111
1322,2020/12/25,GSW,MIL,L 99-138,240,34,99,0.343,24,54,0.444,10,45,0.222,21,25,0.84,99,50,90,0.556,30,54,0.556,20,36,0.556,18,26,0.692,138
1323,2020/12/25,MIL,GSW,W 138-99,240,50,90,0.556,30,54,0.556,20,36,0.556,18,26,0.692,138,34,99,0.343,24,54,0.444,10,45,0.222,21,25,0.84,99
1324,2020/12/23,BOS,MIL,W 122-121,240,48,101,0.475,30,61,0.492,18,40,0.45,8,11,0.727,122,46,90,0.511,32,55,0.582,14,35,0.4,15,18,0.833,121
1325,2020/12/23,MIL,BOS,L 121-122,240,46,90,0.511,32,55,0.582,14,35,0.4,15,18,0.833,121,48,101,0.475,30,61,0.492,18,40,0.45,8,11,0.727,122
1326,2020/12/23,ATL,CHI,W 124-104,240,43,80,0.538,29,45,0.644,14,35,0.4,24,29,0.828,124,36,87,0.414,28,52,0.538,8,35,0.229,24,28,0.857,104
1327,2020/12/23,CHI,ATL,L 104-124,240,36,87,0.414,28,52,0.538,8,35,0.229,24,28,0.857,104,43,80,0.538,29,45,0.644,14,35,0.4,24,29,0.828,124
1328,2020/12/23,CHO,CLE,L 114-121,240,45,90,0.5,29,46,0.63,16,44,0.364,8,15,0.533,114,46,87,0.529,32,57,0.561,14,30,0.467,15,20,0.75,121
1329,2020/12/23,CLE,CHO,W 121-114,240,46,87,0.529,32,57,0.561,14,30,0.467,15,20,0.75,121,45,90,0.5,29,46,0.63,16,44,0.364,8,15,0.533,114
1330,2020/12/23,DEN,SAC,L 122-124 (OT),265,47,98,0.48,39,69,0.565,8,29,0.276,20,24,0.833,122,45,102,0.441,35,71,0.493,10,31,0.323,24,31,0.774,124
1331,2020/12/23,SAC,DEN,W 124-122 (OT),265,45,102,0.441,35,71,0.493,10,31,0.323,24,31,0.774,124,47,98,0.48,39,69,0.565,8,29,0.276,20,24,0.833,122
1332,2020/12/23,IND,NYK,W 121-107,240,46,94,0.489,38,60,0.633,8,34,0.235,21,29,0.724,121,39,85,0.459,27,57,0.474,12,28,0.429,17,23,0.739,107
1333,2020/12/23,NYK,IND,L 107-121,240,39,85,0.459,27,57,0.474,12,28,0.429,17,23,0.739,107,46,94,0.489,38,60,0.633,8,34,0.235,21,29,0.724,121
1334,2020/12/23,MEM,SAS,L 119-131,240,49,95,0.516,39,68,0.574,10,27,0.37,11,18,0.611,119,48,95,0.505,38,70,0.543,10,25,0.4,25,29,0.862,131
1335,2020/12/23,SAS,MEM,W 131-119,240,48,95,0.505,38,70,0.543,10,25,0.4,25,29,0.862,131,49,95,0.516,39,68,0.574,10,27,0.37,11,18,0.611,119
1336,2020/12/23,DET,MIN,L 101-111,240,45,93,0.484,37,58,0.638,8,35,0.229,3,8,0.375,101,38,88,0.432,27,47,0.574,11,41,0.268,24,28,0.857,111
1337,2020/12/23,MIN,DET,W 111-101,240,38,88,0.432,27,47,0.574,11,41,0.268,24,28,0.857,111,45,93,0.484,37,58,0.638,8,35,0.229,3,8,0.375,101
1338,2020/12/23,MIA,ORL,L 107-113,240,42,83,0.506,35,63,0.556,7,20,0.35,16,19,0.842,107,42,88,0.477,32,60,0.533,10,28,0.357,19,30,0.633,113
1339,2020/12/23,ORL,MIA,W 113-107,240,42,88,0.477,32,60,0.533,10,28,0.357,19,30,0.633,113,42,83,0.506,35,63,0.556,7,20,0.35,16,19,0.842,107
1340,2020/12/23,PHI,WAS,W 113-107,240,41,87,0.471,33,59,0.559,8,28,0.286,23,30,0.767,113,39,85,0.459,26,58,0.448,13,27,0.481,16,23,0.696,107
1341,2020/12/23,WAS,PHI,L 107-113,240,39,85,0.459,26,58,0.448,13,27,0.481,16,23,0.696,107,41,87,0.471,33,59,0.559,8,28,0.286,23,30,0.767,113
1342,2020/12/23,DAL,PHO,L 102-106,240,36,85,0.424,27,48,0.563,9,37,0.243,21,26,0.808,102,38,79,0.481,27,49,0.551,11,30,0.367,19,27,0.704,106
1343,2020/12/23,PHO,DAL,W 106-102,240,38,79,0.481,27,49,0.551,11,30,0.367,19,27,0.704,106,36,85,0.424,27,48,0.563,9,37,0.243,21,26,0.808,102
1344,2020/12/23,POR,UTA,L 100-120,240,37,92,0.402,25,59,0.424,12,33,0.364,14,17,0.824,100,43,94,0.457,24,44,0.545,19,50,0.38,15,19,0.789,120
1345,2020/12/23,UTA,POR,W 120-100,240,43,94,0.457,24,44,0.545,19,50,0.38,15,19,0.789,120,37,92,0.402,25,59,0.424,12,33,0.364,14,17,0.824,100
1346,2020/12/23,NOP,TOR,W 113-99,240,42,80,0.525,23,38,0.605,19,42,0.452,10,20,0.5,113,38,89,0.427,24,43,0.558,14,46,0.304,9,12,0.75,99
1347,2020/12/23,TOR,NOP,L 99-113,240,38,89,0.427,24,43,0.558,14,46,0.304,9,12,0.75,99,42,80,0.525,23,38,0.605,19,42,0.452,10,20,0.5,113
1348,2020/12/22,BRK,GSW,W 125-99,240,42,92,0.457,27,57,0.474,15,35,0.429,26,32,0.813,125,37,99,0.374,27,66,0.409,10,33,0.303,15,23,0.652,99
1349,2020/12/22,GSW,BRK,L 99-125,240,37,99,0.374,27,66,0.409,10,33,0.303,15,23,0.652,99,42,92,0.457,27,57,0.474,15,35,0.429,26,32,0.813,125
1350,2020/12/22,LAC,LAL,W 116-109,240,44,93,0.473,30,53,0.566,14,40,0.35,14,19,0.737,116,38,81,0.469,29,52,0.558,9,29,0.31,24,31,0.774,109
1351,2020/12/22,LAL,LAC,L 109-116,240,38,81,0.469,29,52,0.558,9,29,0.31,24,31,0.774,109,44,93,0.473,30,53,0.566,14,40,0.35,14,19,0.737,116
1352,2020/8/14,HOU,PHI,L 96-134,240,35,80,0.438,23,32,0.719,12,48,0.25,14,16,0.875,96,49,87,0.563,31,49,0.633,18,38,0.474,18,22,0.818,134
1353,2020/8/14,PHI,HOU,W 134-96,240,49,87,0.563,31,49,0.633,18,38,0.474,18,22,0.818,134,35,80,0.438,23,32,0.719,12,48,0.25,14,16,0.875,96
1354,2020/8/14,IND,MIA,W 109-92,240,43,89,0.483,28,51,0.549,15,38,0.395,8,11,0.727,109,31,87,0.356,21,49,0.429,10,38,0.263,20,27,0.741,92
1355,2020/8/14,MIA,IND,L 92-109,240,31,87,0.356,21,49,0.429,10,38,0.263,20,27,0.741,92,43,89,0.483,28,51,0.549,15,38,0.395,8,11,0.727,109
1356,2020/8/14,LAC,OKC,W 107-103 (OT),265,34,85,0.4,22,48,0.458,12,37,0.324,27,39,0.692,107,38,106,0.358,24,62,0.387,14,44,0.318,13,22,0.591,103
1357,2020/8/14,OKC,LAC,L 103-107 (OT),265,38,106,0.358,24,62,0.387,14,44,0.318,13,22,0.591,103,34,85,0.4,22,48,0.458,12,37,0.324,27,39,0.692,107
1358,2020/8/14,DEN,TOR,L 109-117,240,36,87,0.414,20,49,0.408,16,38,0.421,21,23,0.913,109,45,90,0.5,27,55,0.491,18,35,0.514,9,14,0.643,117
1359,2020/8/14,TOR,DEN,W 117-109,240,45,90,0.5,27,55,0.491,18,35,0.514,9,14,0.643,117,36,87,0.414,20,49,0.408,16,38,0.421,21,23,0.913,109
1360,2020/8/13,BOS,WAS,L 90-96,240,35,88,0.398,27,53,0.509,8,35,0.229,12,14,0.857,90,34,88,0.386,24,62,0.387,10,26,0.385,18,24,0.75,96
1361,2020/8/13,WAS,BOS,W 96-90,240,34,88,0.386,24,62,0.387,10,26,0.385,18,24,0.75,96,35,88,0.398,27,53,0.509,8,35,0.229,12,14,0.857,90
1362,2020/8/13,BRK,POR,L 133-134,240,53,96,0.552,39,63,0.619,14,33,0.424,13,19,0.684,133,50,104,0.481,37,65,0.569,13,39,0.333,21,24,0.875,134
1363,2020/8/13,POR,BRK,W 134-133,240,50,104,0.481,37,65,0.569,13,39,0.333,21,24,0.875,134,53,96,0.552,39,63,0.619,14,33,0.424,13,19,0.684,133
1364,2020/8/13,LAL,SAC,L 122-136,240,48,98,0.49,33,63,0.524,15,35,0.429,11,15,0.733,122,54,95,0.568,33,48,0.688,21,47,0.447,7,12,0.583,136
1365,2020/8/13,SAC,LAL,W 136-122,240,54,95,0.568,33,48,0.688,21,47,0.447,7,12,0.583,136,48,98,0.49,33,63,0.524,15,35,0.429,11,15,0.733,122
1366,2020/8/13,MEM,MIL,W 119-106,240,45,90,0.5,32,57,0.561,13,33,0.394,16,23,0.696,119,39,98,0.398,26,57,0.456,13,41,0.317,15,23,0.652,106
1367,2020/8/13,MIL,MEM,L 106-119,240,39,98,0.398,26,57,0.456,13,41,0.317,15,23,0.652,106,45,90,0.5,32,57,0.561,13,33,0.394,16,23,0.696,119
1368,2020/8/13,NOP,ORL,L 127-133,240,48,87,0.552,38,53,0.717,10,34,0.294,21,27,0.778,127,48,84,0.571,33,56,0.589,15,28,0.536,22,30,0.733,133
1369,2020/8/13,ORL,NOP,W 133-127,240,48,84,0.571,33,56,0.589,15,28,0.536,22,30,0.733,133,48,87,0.552,38,53,0.717,10,34,0.294,21,27,0.778,127
1370,2020/8/13,DAL,PHO,L 102-128,240,39,89,0.438,31,63,0.492,8,26,0.308,16,19,0.842,102,49,89,0.551,35,55,0.636,14,34,0.412,16,21,0.762,128
1371,2020/8/13,PHO,DAL,W 128-102,240,49,89,0.551,35,55,0.636,14,34,0.412,16,21,0.762,128,39,89,0.438,31,63,0.492,8,26,0.308,16,19,0.842,102
1372,2020/8/13,SAS,UTA,L 112-118,240,39,79,0.494,29,59,0.492,10,20,0.5,24,36,0.667,112,47,101,0.465,32,55,0.582,15,46,0.326,9,10,0.9,118
1373,2020/8/13,UTA,SAS,W 118-112,240,47,101,0.465,32,55,0.582,15,46,0.326,9,10,0.9,118,39,79,0.494,29,59,0.492,10,20,0.5,24,36,0.667,112
1374,2020/8/12,DEN,LAC,L 111-124,240,43,87,0.494,30,52,0.577,13,35,0.371,12,19,0.632,111,46,85,0.541,32,48,0.667,14,37,0.378,18,23,0.783,124
1375,2020/8/12,LAC,DEN,W 124-111,240,46,85,0.541,32,48,0.667,14,37,0.378,18,23,0.783,124,43,87,0.494,30,52,0.577,13,35,0.371,12,19,0.632,111
1376,2020/8/12,HOU,IND,L 104-108,240,32,86,0.372,16,29,0.552,16,57,0.281,24,28,0.857,104,40,100,0.4,29,69,0.42,11,31,0.355,17,22,0.773,108
1377,2020/8/12,IND,HOU,W 108-104,240,40,100,0.4,29,69,0.42,11,31,0.355,17,22,0.773,108,32,86,0.372,16,29,0.552,16,57,0.281,24,28,0.857,104
1378,2020/8/12,MIA,OKC,L 115-116,240,42,86,0.488,28,44,0.636,14,42,0.333,17,20,0.85,115,39,89,0.438,23,47,0.489,16,42,0.381,22,27,0.815,116
1379,2020/8/12,OKC,MIA,W 116-115,240,39,89,0.438,23,47,0.489,16,42,0.381,22,27,0.815,116,42,86,0.488,28,44,0.636,14,42,0.333,17,20,0.85,115
1380,2020/8/12,PHI,TOR,L 121-125,240,39,84,0.464,22,44,0.5,17,40,0.425,26,33,0.788,121,40,90,0.444,22,47,0.468,18,43,0.419,27,40,0.675,125
1381,2020/8/12,TOR,PHI,W 125-121,240,40,90,0.444,22,47,0.468,18,43,0.419,27,40,0.675,125,39,84,0.464,22,44,0.5,17,40,0.425,26,33,0.788,121
1382,2020/8/11,DAL,POR,L 131-134,240,42,81,0.519,22,37,0.595,20,44,0.455,27,33,0.818,131,46,98,0.469,31,60,0.517,15,38,0.395,27,29,0.931,134
1383,2020/8/11,POR,DAL,W 134-131,240,46,98,0.469,31,60,0.517,15,38,0.395,27,29,0.931,134,42,81,0.519,22,37,0.595,20,44,0.455,27,33,0.818,131
1384,2020/8/11,BOS,MEM,W 122-107,240,44,86,0.512,28,49,0.571,16,37,0.432,18,23,0.783,122,35,89,0.393,28,60,0.467,7,29,0.241,30,38,0.789,107
1385,2020/8/11,MEM,BOS,L 107-122,240,35,89,0.393,28,60,0.467,7,29,0.241,30,38,0.789,107,44,86,0.512,28,49,0.571,16,37,0.432,18,23,0.783,122
1386,2020/8/11,BRK,ORL,W 108-96,240,38,89,0.427,25,46,0.543,13,43,0.302,19,24,0.792,108,32,83,0.386,25,60,0.417,7,23,0.304,25,29,0.862,96
1387,2020/8/11,ORL,BRK,L 96-108,240,32,83,0.386,25,60,0.417,7,23,0.304,25,29,0.862,96,38,89,0.427,25,46,0.543,13,43,0.302,19,24,0.792,108
1388,2020/8/11,PHI,PHO,L 117-130,240,46,93,0.495,31,60,0.517,15,33,0.455,10,14,0.714,117,49,89,0.551,37,61,0.607,12,28,0.429,20,21,0.952,130
1389,2020/8/11,PHO,PHI,W 130-117,240,49,89,0.551,37,61,0.607,12,28,0.429,20,21,0.952,130,46,93,0.495,31,60,0.517,15,33,0.455,10,14,0.714,117
1390,2020/8/11,NOP,SAC,L 106-112,240,42,82,0.512,35,58,0.603,7,24,0.292,15,19,0.789,106,43,88,0.489,32,62,0.516,11,26,0.423,15,16,0.938,112
1391,2020/8/11,SAC,NOP,W 112-106,240,43,88,0.489,32,62,0.516,11,26,0.423,15,16,0.938,112,42,82,0.512,35,58,0.603,7,24,0.292,15,19,0.789,106
1392,2020/8/11,HOU,SAS,L 105-123,240,36,89,0.404,22,41,0.537,14,48,0.292,19,21,0.905,105,46,93,0.495,33,61,0.541,13,32,0.406,18,20,0.9,123
1393,2020/8/11,SAS,HOU,W 123-105,240,46,93,0.495,33,61,0.541,13,32,0.406,18,20,0.9,123,36,89,0.404,22,41,0.537,14,48,0.292,19,21,0.905,105
1394,2020/8/11,MIL,WAS,W 126-113,240,44,87,0.506,26,49,0.531,18,38,0.474,20,28,0.714,126,39,95,0.411,27,60,0.45,12,35,0.343,23,30,0.767,113
1395,2020/8/11,WAS,MIL,L 113-126,240,39,95,0.411,27,60,0.45,12,35,0.343,23,30,0.767,113,44,87,0.506,26,49,0.531,18,38,0.474,20,28,0.714,126
1396,2020/8/10,DEN,LAL,L 121-124,240,45,77,0.584,32,54,0.593,13,23,0.565,18,23,0.783,121,44,81,0.543,30,52,0.577,14,29,0.483,22,32,0.688,124
1397,2020/8/10,LAL,DEN,W 124-121,240,44,81,0.543,30,52,0.577,14,29,0.483,22,32,0.688,124,45,77,0.584,32,54,0.593,13,23,0.565,18,23,0.783,121
1398,2020/8/10,IND,MIA,L 92-114,240,33,84,0.393,23,49,0.469,10,35,0.286,16,25,0.64,92,44,98,0.449,31,58,0.534,13,40,0.325,13,19,0.684,114
1399,2020/8/10,MIA,IND,W 114-92,240,44,98,0.449,31,58,0.534,13,40,0.325,13,19,0.684,114,33,84,0.393,23,49,0.469,10,35,0.286,16,25,0.64,92
1400,2020/8/10,MIL,TOR,L 106-114,240,33,84,0.393,19,41,0.463,14,43,0.326,26,35,0.743,106,42,97,0.433,30,57,0.526,12,40,0.3,18,26,0.692,114
1401,2020/8/10,TOR,MIL,W 114-106,240,42,97,0.433,30,57,0.526,12,40,0.3,18,26,0.692,114,33,84,0.393,19,41,0.463,14,43,0.326,26,35,0.743,106
1402,2020/8/10,OKC,PHO,L 101-128,240,35,90,0.389,22,51,0.431,13,39,0.333,18,21,0.857,101,42,89,0.472,25,55,0.455,17,34,0.5,27,29,0.931,128
1403,2020/8/10,PHO,OKC,W 128-101,240,42,89,0.472,25,55,0.455,17,34,0.5,27,29,0.931,128,35,90,0.389,22,51,0.431,13,39,0.333,18,21,0.857,101
1404,2020/8/10,DAL,UTA,W 122-114,240,48,85,0.565,36,61,0.59,12,24,0.5,14,16,0.875,122,39,82,0.476,18,36,0.5,21,46,0.457,15,20,0.75,114
1405,2020/8/10,UTA,DAL,L 114-122,240,39,82,0.476,18,36,0.5,21,46,0.457,15,20,0.75,114,48,85,0.565,36,61,0.59,12,24,0.5,14,16,0.875,122
1406,2020/8/9,BOS,ORL,W 122-119 (OT),265,45,102,0.441,33,62,0.532,12,40,0.3,20,24,0.833,122,41,102,0.402,26,55,0.473,15,47,0.319,22,26,0.846,119
1407,2020/8/9,ORL,BOS,L 119-122 (OT),265,41,102,0.402,26,55,0.473,15,47,0.319,22,26,0.846,119,45,102,0.441,33,62,0.532,12,40,0.3,20,24,0.833,122
1408,2020/8/9,BRK,LAC,W 129-120,240,47,85,0.553,27,42,0.643,20,43,0.465,15,19,0.789,129,45,93,0.484,32,57,0.561,13,36,0.361,17,20,0.85,120
1409,2020/8/9,LAC,BRK,L 120-129,240,45,93,0.484,32,57,0.561,13,36,0.361,17,20,0.85,120,47,85,0.553,27,42,0.643,20,43,0.465,15,19,0.789,129
1410,2020/8/9,NOP,SAS,L 113-122,240,42,96,0.438,30,66,0.455,12,30,0.4,17,22,0.773,113,40,89,0.449,29,61,0.475,11,28,0.393,31,32,0.969,122
1411,2020/8/9,SAS,NOP,W 122-113,240,40,89,0.449,29,61,0.475,11,28,0.393,31,32,0.969,122,42,96,0.438,30,66,0.455,12,30,0.4,17,22,0.773,113
1412,2020/8/9,OKC,WAS,W 121-103,240,43,84,0.512,25,45,0.556,18,39,0.462,17,22,0.773,121,38,92,0.413,29,56,0.518,9,36,0.25,18,22,0.818,103
1413,2020/8/9,WAS,OKC,L 103-121,240,38,92,0.413,29,56,0.518,9,36,0.25,18,22,0.818,103,43,84,0.512,25,45,0.556,18,39,0.462,17,22,0.773,121
1414,2020/8/9,PHI,POR,L 121-124,240,47,97,0.485,33,67,0.493,14,30,0.467,13,17,0.765,121,43,91,0.473,32,56,0.571,11,35,0.314,27,29,0.931,124
1415,2020/8/9,POR,PHI,W 124-121,240,43,91,0.473,32,56,0.571,11,35,0.314,27,29,0.931,124,47,97,0.485,33,67,0.493,14,30,0.467,13,17,0.765,121
1416,2020/8/9,HOU,SAC,W 129-112,240,43,91,0.473,25,34,0.735,18,57,0.316,25,30,0.833,129,41,87,0.471,31,50,0.62,10,37,0.27,20,23,0.87,112
1417,2020/8/9,SAC,HOU,L 112-129,240,41,87,0.471,31,50,0.62,10,37,0.27,20,23,0.87,112,43,91,0.473,25,34,0.735,18,57,0.316,25,30,0.833,129
1418,2020/8/9,MEM,TOR,L 99-108,240,37,91,0.407,23,49,0.469,14,42,0.333,11,16,0.688,99,34,71,0.479,19,32,0.594,15,39,0.385,25,33,0.758,108
1419,2020/8/9,TOR,MEM,W 108-99,240,34,71,0.479,19,32,0.594,15,39,0.385,25,33,0.758,108,37,91,0.407,23,49,0.469,14,42,0.333,11,16,0.688,99
1420,2020/8/8,DAL,MIL,W 136-132 (OT),265,48,115,0.417,31,62,0.5,17,53,0.321,23,25,0.92,136,47,99,0.475,32,55,0.582,15,44,0.341,23,34,0.676,132
1421,2020/8/8,MIL,DAL,L 132-136 (OT),265,47,99,0.475,32,55,0.582,15,44,0.341,23,34,0.676,132,48,115,0.417,31,62,0.5,17,53,0.321,23,25,0.92,136
1422,2020/8/8,DEN,UTA,W 134-132 (2OT),290,51,108,0.472,42,71,0.592,9,37,0.243,23,30,0.767,134,47,105,0.448,25,50,0.5,22,55,0.4,16,22,0.727,132
1423,2020/8/8,UTA,DEN,L 132-134 (2OT),290,47,105,0.448,25,50,0.5,22,55,0.4,16,22,0.727,132,51,108,0.472,42,71,0.592,9,37,0.243,23,30,0.767,134
1424,2020/8/8,IND,LAL,W 116-111,240,44,84,0.524,29,51,0.569,15,33,0.455,13,14,0.929,116,42,100,0.42,29,61,0.475,13,39,0.333,14,19,0.737,111
1425,2020/8/8,LAL,IND,L 111-116,240,42,100,0.42,29,61,0.475,13,39,0.333,14,19,0.737,111,44,84,0.524,29,51,0.569,15,33,0.455,13,14,0.929,116
1426,2020/8/8,MIA,PHO,L 112-119,240,41,84,0.488,30,48,0.625,11,36,0.306,19,22,0.864,112,44,92,0.478,32,60,0.533,12,32,0.375,19,20,0.95,119
1427,2020/8/8,PHO,MIA,W 119-112,240,44,92,0.478,32,60,0.533,12,32,0.375,19,20,0.95,119,41,84,0.488,30,48,0.625,11,36,0.306,19,22,0.864,112
1428,2020/8/8,LAC,POR,W 122-117,240,42,85,0.494,27,51,0.529,15,34,0.441,23,28,0.821,122,44,90,0.489,27,47,0.574,17,43,0.395,12,17,0.706,117
1429,2020/8/8,POR,LAC,L 117-122,240,44,90,0.489,27,47,0.574,17,43,0.395,12,17,0.706,117,42,85,0.494,27,51,0.529,15,34,0.441,23,28,0.821,122
1430,2020/8/7,BRK,SAC,W 119-106,240,42,86,0.488,25,46,0.543,17,40,0.425,18,28,0.643,119,38,89,0.427,26,49,0.531,12,40,0.3,18,24,0.75,106
1431,2020/8/7,SAC,BRK,L 106-119,240,38,89,0.427,26,49,0.531,12,40,0.3,18,24,0.75,106,42,86,0.488,25,46,0.543,17,40,0.425,18,28,0.643,119
1432,2020/8/7,MEM,OKC,W 121-92,240,46,83,0.554,35,52,0.673,11,31,0.355,18,20,0.9,121,34,97,0.351,21,54,0.389,13,43,0.302,11,15,0.733,92
1433,2020/8/7,OKC,MEM,L 92-121,240,34,97,0.351,21,54,0.389,13,43,0.302,11,15,0.733,92,46,83,0.554,35,52,0.673,11,31,0.355,18,20,0.9,121
1434,2020/8/7,NOP,WAS,W 118-107,240,42,88,0.477,30,53,0.566,12,35,0.343,22,26,0.846,118,38,90,0.422,28,63,0.444,10,27,0.37,21,23,0.913,107
1435,2020/8/7,WAS,NOP,L 107-118,240,38,90,0.422,28,63,0.444,10,27,0.37,21,23,0.913,107,42,88,0.477,30,53,0.566,12,35,0.343,22,26,0.846,118
1436,2020/8/7,ORL,PHI,L 101-108,240,37,88,0.42,29,56,0.518,8,32,0.25,19,25,0.76,101,38,93,0.409,30,64,0.469,8,29,0.276,24,33,0.727,108
1437,2020/8/7,PHI,ORL,W 108-101,240,38,93,0.409,30,64,0.469,8,29,0.276,24,33,0.727,108,37,88,0.42,29,56,0.518,8,32,0.25,19,25,0.76,101
1438,2020/8/7,SAS,UTA,W 119-111,240,45,89,0.506,36,67,0.537,9,22,0.409,20,26,0.769,119,38,91,0.418,22,54,0.407,16,37,0.432,19,24,0.792,111
1439,2020/8/7,UTA,SAS,L 111-119,240,38,91,0.418,22,54,0.407,16,37,0.432,19,24,0.792,111,45,89,0.506,36,67,0.537,9,22,0.409,20,26,0.769,119
1440,2020/8/7,BOS,TOR,W 122-100,240,47,96,0.49,31,50,0.62,16,46,0.348,12,16,0.75,122,38,89,0.427,28,51,0.549,10,38,0.263,14,17,0.824,100
1441,2020/8/7,TOR,BOS,L 100-122,240,38,89,0.427,28,51,0.549,10,38,0.263,14,17,0.824,100,47,96,0.49,31,50,0.62,16,46,0.348,12,16,0.75,122
1442,2020/8/6,DAL,LAC,L 111-126,240,39,87,0.448,22,39,0.564,17,48,0.354,16,21,0.762,111,50,92,0.543,36,61,0.59,14,31,0.452,12,15,0.8,126
1443,2020/8/6,LAC,DAL,W 126-111,240,50,92,0.543,36,61,0.59,14,31,0.452,12,15,0.8,126,39,87,0.448,22,39,0.564,17,48,0.354,16,21,0.762,111
1444,2020/8/6,DEN,POR,L 115-125,240,44,84,0.524,30,56,0.536,14,28,0.5,13,17,0.765,115,43,92,0.467,20,53,0.377,23,39,0.59,16,20,0.8,125
1445,2020/8/6,POR,DEN,W 125-115,240,43,92,0.467,20,53,0.377,23,39,0.59,16,20,0.8,125,44,84,0.524,30,56,0.536,14,28,0.5,13,17,0.765,115
1446,2020/8/6,HOU,LAL,W 113-97,240,36,84,0.429,15,27,0.556,21,57,0.368,20,23,0.87,113,35,77,0.455,33,58,0.569,2,19,0.105,25,36,0.694,97
1447,2020/8/6,LAL,HOU,L 97-113,240,35,77,0.455,33,58,0.569,2,19,0.105,25,36,0.694,97,36,84,0.429,15,27,0.556,21,57,0.368,20,23,0.87,113
1448,2020/8/6,MIA,MIL,L 116-130,240,35,83,0.422,14,37,0.378,21,46,0.457,25,27,0.926,116,41,78,0.526,26,41,0.634,15,37,0.405,33,38,0.868,130
1449,2020/8/6,MIL,MIA,W 130-116,240,41,78,0.526,26,41,0.634,15,37,0.405,33,38,0.868,130,35,83,0.422,14,37,0.378,21,46,0.457,25,27,0.926,116
1450,2020/8/6,IND,PHO,L 99-114,240,37,85,0.435,27,56,0.482,10,29,0.345,15,19,0.789,99,43,92,0.467,34,58,0.586,9,34,0.265,19,20,0.95,114
1451,2020/8/6,PHO,IND,W 114-99,240,43,92,0.467,34,58,0.586,9,34,0.265,19,20,0.95,114,37,85,0.435,27,56,0.482,10,29,0.345,15,19,0.789,99
1452,2020/8/6,NOP,SAC,L 125-140,240,47,82,0.573,33,48,0.688,14,34,0.412,17,23,0.739,125,50,93,0.538,34,60,0.567,16,33,0.485,24,33,0.727,140
1453,2020/8/6,SAC,NOP,W 140-125,240,50,93,0.538,34,60,0.567,16,33,0.485,24,33,0.727,140,47,82,0.573,33,48,0.688,14,34,0.412,17,23,0.739,125
1454,2020/8/5,BOS,BRK,W 149-115,240,50,88,0.568,30,49,0.612,20,39,0.513,29,35,0.829,149,45,95,0.474,37,63,0.587,8,32,0.25,17,21,0.81,115
1455,2020/8/5,BRK,BOS,L 115-149,240,45,95,0.474,37,63,0.587,8,32,0.25,17,21,0.81,115,50,88,0.568,30,49,0.612,20,39,0.513,29,35,0.829,149
1456,2020/8/5,LAL,OKC,L 86-105,240,31,88,0.352,26,51,0.51,5,37,0.135,19,29,0.655,86,34,79,0.43,29,55,0.527,5,24,0.208,32,36,0.889,105
1457,2020/8/5,OKC,LAL,W 105-86,240,34,79,0.43,29,55,0.527,5,24,0.208,32,36,0.889,105,31,88,0.352,26,51,0.51,5,37,0.135,19,29,0.655,86
1458,2020/8/5,ORL,TOR,L 99-109,240,35,87,0.402,24,46,0.522,11,41,0.268,18,26,0.692,99,38,78,0.487,26,45,0.578,12,33,0.364,21,30,0.7,109
1459,2020/8/5,TOR,ORL,W 109-99,240,38,78,0.487,26,45,0.578,12,33,0.364,21,30,0.7,109,35,87,0.402,24,46,0.522,11,41,0.268,18,26,0.692,99
1460,2020/8/5,DEN,SAS,W 132-126,240,50,91,0.549,36,55,0.655,14,36,0.389,18,21,0.857,132,46,93,0.495,35,63,0.556,11,30,0.367,23,27,0.852,126
1461,2020/8/5,SAS,DEN,L 126-132,240,46,93,0.495,35,63,0.556,11,30,0.367,23,27,0.852,126,50,91,0.549,36,55,0.655,14,36,0.389,18,21,0.857,132
1462,2020/8/5,MEM,UTA,L 115-124,240,43,91,0.473,32,62,0.516,11,29,0.379,18,25,0.72,115,38,84,0.452,20,39,0.513,18,45,0.4,30,33,0.909,124
1463,2020/8/5,UTA,MEM,W 124-115,240,38,84,0.452,20,39,0.513,18,45,0.4,30,33,0.909,124,43,91,0.473,32,62,0.516,11,29,0.379,18,25,0.72,115
1464,2020/8/5,PHI,WAS,W 107-98,240,38,82,0.463,27,53,0.509,11,29,0.379,20,29,0.69,107,36,85,0.424,29,64,0.453,7,21,0.333,19,24,0.792,98
1465,2020/8/5,WAS,PHI,L 98-107,240,36,85,0.424,29,64,0.453,7,21,0.333,19,24,0.792,98,38,82,0.463,27,53,0.509,11,29,0.379,20,29,0.69,107
1466,2020/8/4,IND,ORL,W 120-109,240,46,84,0.548,33,51,0.647,13,33,0.394,15,19,0.789,120,39,82,0.476,27,48,0.563,12,34,0.353,19,23,0.826,109
1467,2020/8/4,ORL,IND,L 109-120,240,39,82,0.476,27,48,0.563,12,34,0.353,19,23,0.826,109,46,84,0.548,33,51,0.647,13,33,0.394,15,19,0.789,120
1468,2020/8/4,LAC,PHO,L 115-117,240,42,85,0.494,34,56,0.607,8,29,0.276,23,27,0.852,115,45,96,0.469,28,64,0.438,17,32,0.531,10,14,0.714,117
1469,2020/8/4,PHO,LAC,W 117-115,240,45,96,0.469,28,64,0.438,17,32,0.531,10,14,0.714,117,42,85,0.494,34,56,0.607,8,29,0.276,23,27,0.852,115
1470,2020/8/4,BOS,MIA,L 106-112,240,37,85,0.435,27,52,0.519,10,33,0.303,22,27,0.815,106,34,77,0.442,19,34,0.559,15,43,0.349,29,39,0.744,112
1471,2020/8/4,MIA,BOS,W 112-106,240,34,77,0.442,19,34,0.559,15,43,0.349,29,39,0.744,112,37,85,0.435,27,52,0.519,10,33,0.303,22,27,0.815,106
1472,2020/8/4,BRK,MIL,W 119-116,240,43,103,0.417,22,46,0.478,21,57,0.368,12,16,0.75,119,42,88,0.477,25,37,0.676,17,51,0.333,15,23,0.652,116
1473,2020/8/4,MIL,BRK,L 116-119,240,42,88,0.477,25,37,0.676,17,51,0.333,15,23,0.652,116,43,103,0.417,22,46,0.478,21,57,0.368,12,16,0.75,119
1474,2020/8/4,HOU,POR,L 102-110,240,34,87,0.391,15,34,0.441,19,53,0.358,15,24,0.625,102,39,95,0.411,27,64,0.422,12,31,0.387,20,29,0.69,110
1475,2020/8/4,POR,HOU,W 110-102,240,39,95,0.411,27,64,0.422,12,31,0.387,20,29,0.69,110,34,87,0.391,15,34,0.441,19,53,0.358,15,24,0.625,102
1476,2020/8/4,DAL,SAC,W 114-110 (OT),265,33,90,0.367,24,49,0.49,9,41,0.22,39,50,0.78,114,43,104,0.413,27,61,0.443,16,43,0.372,8,12,0.667,110
1477,2020/8/4,SAC,DAL,L 110-114 (OT),265,43,104,0.413,27,61,0.443,16,43,0.372,8,12,0.667,110,33,90,0.367,24,49,0.49,9,41,0.22,39,50,0.78,114
1478,2020/8/3,MIA,TOR,L 103-107,240,37,87,0.425,23,42,0.548,14,45,0.311,15,16,0.938,103,29,67,0.433,13,35,0.371,16,32,0.5,33,36,0.917,107
1479,2020/8/3,TOR,MIA,W 107-103,240,29,67,0.433,13,35,0.371,16,32,0.5,33,36,0.917,107,37,87,0.425,23,42,0.548,14,45,0.311,15,16,0.938,103
1480,2020/8/3,MEM,NOP,L 99-109,240,37,93,0.398,25,50,0.5,12,43,0.279,13,15,0.867,99,37,82,0.451,26,53,0.491,11,29,0.379,24,39,0.615,109
1481,2020/8/3,NOP,MEM,W 109-99,240,37,82,0.451,26,53,0.491,11,29,0.379,24,39,0.615,109,37,93,0.398,25,50,0.5,12,43,0.279,13,15,0.867,99
1482,2020/8/3,DEN,OKC,W 121-113 (OT),265,42,87,0.483,35,62,0.565,7,25,0.28,30,39,0.769,121,37,87,0.425,22,51,0.431,15,36,0.417,24,31,0.774,113
1483,2020/8/3,OKC,DEN,L 113-121 (OT),265,37,87,0.425,22,51,0.431,15,36,0.417,24,31,0.774,113,42,87,0.483,35,62,0.565,7,25,0.28,30,39,0.769,121
1484,2020/8/3,PHI,SAS,W 132-130,240,46,87,0.529,32,56,0.571,14,31,0.452,26,30,0.867,132,46,93,0.495,34,67,0.507,12,26,0.462,26,29,0.897,130
1485,2020/8/3,SAS,PHI,L 130-132,240,46,93,0.495,34,67,0.507,12,26,0.462,26,29,0.897,130,46,87,0.529,32,56,0.571,14,31,0.452,26,30,0.867,132
1486,2020/8/3,LAL,UTA,W 116-108,240,41,82,0.5,32,56,0.571,9,26,0.346,25,31,0.806,116,37,83,0.446,25,40,0.625,12,43,0.279,22,25,0.88,108
1487,2020/8/3,UTA,LAL,L 108-116,240,37,83,0.446,25,40,0.625,12,43,0.279,22,25,0.88,108,41,82,0.5,32,56,0.571,9,26,0.346,25,31,0.806,116
1488,2020/8/3,IND,WAS,W 111-100,240,44,92,0.478,37,66,0.561,7,26,0.269,16,16,1,111,41,94,0.436,30,64,0.469,11,30,0.367,7,13,0.538,100
1489,2020/8/3,WAS,IND,L 100-111,240,41,94,0.436,30,64,0.469,11,30,0.367,7,13,0.538,100,44,92,0.478,37,66,0.561,7,26,0.269,16,16,1,111
1490,2020/8/2,BOS,POR,W 128-124,240,42,77,0.545,24,47,0.511,18,30,0.6,26,34,0.765,128,45,90,0.5,26,48,0.542,19,42,0.452,15,16,0.938,124
1491,2020/8/2,POR,BOS,L 124-128,240,45,90,0.5,26,48,0.542,19,42,0.452,15,16,0.938,124,42,77,0.545,24,47,0.511,18,30,0.6,26,34,0.765,128
1492,2020/8/2,BRK,WAS,W 118-110,240,38,90,0.422,27,57,0.474,11,33,0.333,31,37,0.838,118,40,88,0.455,31,57,0.544,9,31,0.29,21,27,0.778,110
1493,2020/8/2,WAS,BRK,L 110-118,240,40,88,0.455,31,57,0.544,9,31,0.29,21,27,0.778,110,38,90,0.422,27,57,0.474,11,33,0.333,31,37,0.838,118
1494,2020/8/2,HOU,MIL,W 120-116,240,36,91,0.396,15,30,0.5,21,61,0.344,27,31,0.871,120,45,92,0.489,36,57,0.632,9,35,0.257,17,23,0.739,116
1495,2020/8/2,MIL,HOU,L 116-120,240,45,92,0.489,36,57,0.632,9,35,0.257,17,23,0.739,116,36,91,0.396,15,30,0.5,21,61,0.344,27,31,0.871,120
1496,2020/8/2,MEM,SAS,L 106-108,240,42,91,0.462,35,61,0.574,7,30,0.233,15,18,0.833,106,36,86,0.419,24,57,0.421,12,29,0.414,24,33,0.727,108
1497,2020/8/2,SAS,MEM,W 108-106,240,36,86,0.419,24,57,0.421,12,29,0.414,24,33,0.727,108,42,91,0.462,35,61,0.574,7,30,0.233,15,18,0.833,106
1498,2020/8/2,ORL,SAC,W 132-116,240,43,82,0.524,25,44,0.568,18,38,0.474,28,35,0.8,132,45,91,0.495,37,63,0.587,8,28,0.286,18,22,0.818,116
1499,2020/8/2,SAC,ORL,L 116-132,240,45,91,0.495,37,63,0.587,8,28,0.286,18,22,0.818,116,43,82,0.524,25,44,0.568,18,38,0.474,28,35,0.8,132
1500,2020/8/2,DAL,PHO,L 115-117,240,38,93,0.409,32,62,0.516,6,31,0.194,33,37,0.892,115,42,93,0.452,30,60,0.5,12,33,0.364,21,23,0.913,117
1501,2020/8/2,PHO,DAL,W 117-115,240,42,93,0.452,30,60,0.5,12,33,0.364,21,23,0.913,117,38,93,0.409,32,62,0.516,6,31,0.194,33,37,0.892,115
1502,2020/8/1,DEN,MIA,L 105-125,240,39,89,0.438,31,54,0.574,8,35,0.229,19,24,0.792,105,40,72,0.556,27,43,0.628,13,29,0.448,32,37,0.865,125
1503,2020/8/1,MIA,DEN,W 125-105,240,40,72,0.556,27,43,0.628,13,29,0.448,32,37,0.865,125,39,89,0.438,31,54,0.574,8,35,0.229,19,24,0.792,105
1504,2020/8/1,IND,PHI,W 127-121,240,48,95,0.505,34,61,0.557,14,34,0.412,17,23,0.739,127,46,93,0.495,37,68,0.544,9,25,0.36,20,25,0.8,121
1505,2020/8/1,PHI,IND,L 121-127,240,46,93,0.495,37,68,0.544,9,25,0.36,20,25,0.8,121,48,95,0.505,34,61,0.557,14,34,0.412,17,23,0.739,127
1506,2020/8/1,LAC,NOP,W 126-103,240,37,87,0.425,12,40,0.3,25,47,0.532,27,35,0.771,126,38,85,0.447,29,55,0.527,9,30,0.3,18,28,0.643,103
1507,2020/8/1,NOP,LAC,L 103-126,240,38,85,0.447,29,55,0.527,9,30,0.3,18,28,0.643,103,37,87,0.425,12,40,0.3,25,47,0.532,27,35,0.771,126
1508,2020/8/1,OKC,UTA,W 110-94,240,41,77,0.532,31,51,0.608,10,26,0.385,18,24,0.75,110,34,87,0.391,26,56,0.464,8,31,0.258,18,22,0.818,94
1509,2020/8/1,UTA,OKC,L 94-110,240,34,87,0.391,26,56,0.464,8,31,0.258,18,22,0.818,94,41,77,0.532,31,51,0.608,10,26,0.385,18,24,0.75,110
1510,2020/8/1,LAL,TOR,L 92-107,240,29,82,0.354,19,42,0.452,10,40,0.25,24,33,0.727,92,35,84,0.417,21,50,0.42,14,34,0.412,23,26,0.885,107
1511,2020/8/1,TOR,LAL,W 107-92,240,35,84,0.417,21,50,0.42,14,34,0.412,23,26,0.885,107,29,82,0.354,19,42,0.452,10,40,0.25,24,33,0.727,92
1512,2020/7/31,BRK,ORL,L 118-128,240,44,91,0.484,31,49,0.633,13,42,0.31,17,23,0.739,118,46,87,0.529,35,56,0.625,11,31,0.355,25,28,0.893,128
1513,2020/7/31,ORL,BRK,W 128-118,240,46,87,0.529,35,56,0.625,11,31,0.355,25,28,0.893,128,44,91,0.484,31,49,0.633,13,42,0.31,17,23,0.739,118
1514,2020/7/31,DAL,HOU,L 149-153 (OT),265,50,105,0.476,29,56,0.518,21,49,0.429,28,38,0.737,149,52,101,0.515,33,53,0.623,19,48,0.396,30,39,0.769,153
1515,2020/7/31,HOU,DAL,W 153-149 (OT),265,52,101,0.515,33,53,0.623,19,48,0.396,30,39,0.769,153,50,105,0.476,29,56,0.518,21,49,0.429,28,38,0.737,149
1516,2020/7/31,BOS,MIL,L 112-119,240,37,91,0.407,26,54,0.481,11,37,0.297,27,34,0.794,112,39,84,0.464,26,43,0.605,13,41,0.317,28,34,0.824,119
1517,2020/7/31,MIL,BOS,W 119-112,240,39,84,0.464,26,43,0.605,13,41,0.317,28,34,0.824,119,37,91,0.407,26,54,0.481,11,37,0.297,27,34,0.794,112
1518,2020/7/31,MEM,POR,L 135-140 (OT),265,42,93,0.452,29,52,0.558,13,41,0.317,38,50,0.76,135,49,91,0.538,36,61,0.59,13,30,0.433,29,34,0.853,140
1519,2020/7/31,POR,MEM,W 140-135 (OT),265,49,91,0.538,36,61,0.59,13,30,0.433,29,34,0.853,140,42,93,0.452,29,52,0.558,13,41,0.317,38,50,0.76,135
1520,2020/7/31,SAC,SAS,L 120-129,240,46,95,0.484,34,57,0.596,12,38,0.316,16,20,0.8,120,48,90,0.533,37,65,0.569,11,25,0.44,22,27,0.815,129
1521,2020/7/31,SAS,SAC,W 129-120,240,48,90,0.533,37,65,0.569,11,25,0.44,22,27,0.815,129,46,95,0.484,34,57,0.596,12,38,0.316,16,20,0.8,120
1522,2020/7/31,PHO,WAS,W 125-112,240,42,80,0.525,31,48,0.646,11,32,0.344,30,32,0.938,125,42,91,0.462,34,69,0.493,8,22,0.364,20,23,0.87,112
1523,2020/7/31,WAS,PHO,L 112-125,240,42,91,0.462,34,69,0.493,8,22,0.364,20,23,0.87,112,42,80,0.525,31,48,0.646,11,32,0.344,30,32,0.938,125
1524,2020/7/30,LAC,LAL,L 101-103,240,32,74,0.432,16,38,0.421,16,36,0.444,21,28,0.75,101,32,82,0.39,21,46,0.457,11,36,0.306,28,37,0.757,103
1525,2020/7/30,LAL,LAC,W 103-101,240,32,82,0.39,21,46,0.457,11,36,0.306,28,37,0.757,103,32,74,0.432,16,38,0.421,16,36,0.444,21,28,0.75,101
1526,2020/7/30,NOP,UTA,L 104-106,240,40,94,0.426,29,63,0.46,11,31,0.355,13,18,0.722,104,37,84,0.44,29,50,0.58,8,34,0.235,24,28,0.857,106
1527,2020/7/30,UTA,NOP,W 106-104,240,37,84,0.44,29,50,0.58,8,34,0.235,24,28,0.857,106,40,94,0.426,29,63,0.46,11,31,0.355,13,18,0.722,104
1528,2020/3/11,ATL,NYK,L 131-136 (OT),265,48,106,0.453,34,65,0.523,14,41,0.341,21,26,0.808,131,50,94,0.532,39,66,0.591,11,28,0.393,25,34,0.735,136
1529,2020/3/11,NYK,ATL,W 136-131 (OT),265,50,94,0.532,39,66,0.591,11,28,0.393,25,34,0.735,136,48,106,0.453,34,65,0.523,14,41,0.341,21,26,0.808,131
1530,2020/3/11,DAL,DEN,W 113-97,240,42,92,0.457,30,57,0.526,12,35,0.343,17,23,0.739,113,39,83,0.47,25,44,0.568,14,39,0.359,5,8,0.625,97
1531,2020/3/11,DEN,DAL,L 97-113,240,39,83,0.47,25,44,0.568,14,39,0.359,5,8,0.625,97,42,92,0.457,30,57,0.526,12,35,0.343,17,23,0.739,113
1532,2020/3/11,CHO,MIA,W 109-98,240,37,82,0.451,20,48,0.417,17,34,0.5,18,22,0.818,109,39,84,0.464,24,40,0.6,15,44,0.341,5,6,0.833,98
1533,2020/3/11,MIA,CHO,L 98-109,240,39,84,0.464,24,40,0.6,15,44,0.341,5,6,0.833,98,37,82,0.451,20,48,0.417,17,34,0.5,18,22,0.818,109
1534,2020/3/11,DET,PHI,L 106-124,240,39,84,0.464,28,49,0.571,11,35,0.314,17,25,0.68,106,42,83,0.506,28,50,0.56,14,33,0.424,26,32,0.813,124
1535,2020/3/11,PHI,DET,W 124-106,240,42,83,0.506,28,50,0.56,14,33,0.424,26,32,0.813,124,39,84,0.464,28,49,0.571,11,35,0.314,17,25,0.68,106
1536,2020/3/10,CHI,CLE,W 108-103,240,42,84,0.5,30,50,0.6,12,34,0.353,12,15,0.8,108,40,80,0.5,34,56,0.607,6,24,0.25,17,23,0.739,103
1537,2020/3/10,CLE,CHI,L 103-108,240,40,80,0.5,34,56,0.607,6,24,0.25,17,23,0.739,103,42,84,0.5,30,50,0.6,12,34,0.353,12,15,0.8,108
1538,2020/3/10,GSW,LAC,L 107-131,240,37,79,0.468,26,41,0.634,11,38,0.289,22,27,0.815,107,46,92,0.5,26,48,0.542,20,44,0.455,19,19,1,131
1539,2020/3/10,LAC,GSW,W 131-107,240,46,92,0.5,26,48,0.542,20,44,0.455,19,19,1,131,37,79,0.468,26,41,0.634,11,38,0.289,22,27,0.815,107
1540,2020/3/10,HOU,MIN,W 117-111,240,41,80,0.513,26,42,0.619,15,38,0.395,20,26,0.769,117,40,83,0.482,26,48,0.542,14,35,0.4,17,23,0.739,111
1541,2020/3/10,MIN,HOU,L 111-117,240,40,83,0.482,26,48,0.542,14,35,0.4,17,23,0.739,111,41,80,0.513,26,42,0.619,15,38,0.395,20,26,0.769,117
1542,2020/3/10,BOS,IND,W 114-111,240,41,93,0.441,28,56,0.5,13,37,0.351,19,22,0.864,114,46,93,0.495,37,69,0.536,9,24,0.375,10,11,0.909,111
1543,2020/3/10,IND,BOS,L 111-114,240,46,93,0.495,37,69,0.536,9,24,0.375,10,11,0.909,111,41,93,0.441,28,56,0.5,13,37,0.351,19,22,0.864,114
1544,2020/3/10,BRK,LAL,W 104-102,240,37,90,0.411,24,50,0.48,13,40,0.325,17,23,0.739,104,40,87,0.46,25,47,0.532,15,40,0.375,7,12,0.583,102
1545,2020/3/10,LAL,BRK,L 102-104,240,40,87,0.46,25,47,0.532,15,40,0.375,7,12,0.583,102,37,90,0.411,24,50,0.48,13,40,0.325,17,23,0.739,104
1546,2020/3/10,MEM,ORL,L 115-120,240,38,76,0.5,27,47,0.574,11,29,0.379,28,38,0.737,115,43,92,0.467,29,59,0.492,14,33,0.424,20,22,0.909,120
1547,2020/3/10,ORL,MEM,W 120-115,240,43,92,0.467,29,59,0.492,14,33,0.424,20,22,0.909,120,38,76,0.5,27,47,0.574,11,29,0.379,28,38,0.737,115
1548,2020/3/10,PHO,POR,L 105-121,240,35,87,0.402,24,55,0.436,11,32,0.344,24,25,0.96,105,45,89,0.506,28,54,0.519,17,35,0.486,14,17,0.824,121
1549,2020/3/10,POR,PHO,W 121-105,240,45,89,0.506,28,54,0.519,17,35,0.486,14,17,0.824,121,35,87,0.402,24,55,0.436,11,32,0.344,24,25,0.96,105
1550,2020/3/10,DAL,SAS,L 109-119,240,42,92,0.457,25,48,0.521,17,44,0.386,8,11,0.727,109,46,89,0.517,31,57,0.544,15,32,0.469,12,15,0.8,119
1551,2020/3/10,SAS,DAL,W 119-109,240,46,89,0.517,31,57,0.544,15,32,0.469,12,15,0.8,119,42,92,0.457,25,48,0.521,17,44,0.386,8,11,0.727,109
1552,2020/3/10,NYK,WAS,L 115-122,240,42,81,0.519,34,60,0.567,8,21,0.381,23,31,0.742,115,35,74,0.473,21,39,0.538,14,35,0.4,38,45,0.844,122
1553,2020/3/10,WAS,NYK,W 122-115,240,35,74,0.473,21,39,0.538,14,35,0.4,38,45,0.844,122,42,81,0.519,34,60,0.567,8,21,0.381,23,31,0.742,115
1554,2020/3/9,ATL,CHO,W 143-138 (2OT),290,53,96,0.552,32,53,0.604,21,43,0.488,16,27,0.593,143,49,104,0.471,30,56,0.536,19,48,0.396,21,23,0.913,138
1555,2020/3/9,CHO,ATL,L 138-143 (2OT),290,49,104,0.471,30,56,0.536,19,48,0.396,21,23,0.913,138,53,96,0.552,32,53,0.604,21,43,0.488,16,27,0.593,143
1556,2020/3/9,DEN,MIL,W 109-95,240,41,94,0.436,25,53,0.472,16,41,0.39,11,12,0.917,109,34,90,0.378,19,40,0.475,15,50,0.3,12,18,0.667,95
1557,2020/3/9,MIL,DEN,L 95-109,240,34,90,0.378,19,40,0.475,15,50,0.3,12,18,0.667,95,41,94,0.436,25,53,0.472,16,41,0.39,11,12,0.917,109
1558,2020/3/9,TOR,UTA,W 101-92,240,36,83,0.434,23,47,0.489,13,36,0.361,16,18,0.889,101,33,83,0.398,17,40,0.425,16,43,0.372,10,14,0.714,92
1559,2020/3/9,UTA,TOR,L 92-101,240,33,83,0.398,17,40,0.425,16,43,0.372,10,14,0.714,92,36,83,0.434,23,47,0.489,13,36,0.361,16,18,0.889,101
1560,2020/3/8,BOS,OKC,L 104-105,240,38,92,0.413,25,55,0.455,13,37,0.351,15,19,0.789,104,35,79,0.443,25,54,0.463,10,25,0.4,25,34,0.735,105
1561,2020/3/8,OKC,BOS,W 105-104,240,35,79,0.443,25,54,0.463,10,25,0.4,25,34,0.735,105,38,92,0.413,25,55,0.455,13,37,0.351,15,19,0.789,104
1562,2020/3/8,BRK,CHI,W 110-107,240,32,64,0.5,21,34,0.618,11,30,0.367,35,41,0.854,110,39,92,0.424,27,58,0.466,12,34,0.353,17,25,0.68,107
1563,2020/3/8,CHI,BRK,L 107-110,240,39,92,0.424,27,58,0.466,12,34,0.353,17,25,0.68,107,32,64,0.5,21,34,0.618,11,30,0.367,35,41,0.854,110
1564,2020/3/8,CLE,SAS,W 132-129 (OT),265,43,94,0.457,30,60,0.5,13,34,0.382,33,45,0.733,132,43,98,0.439,33,72,0.458,10,26,0.385,33,36,0.917,129
1565,2020/3/8,SAS,CLE,L 129-132 (OT),265,43,98,0.439,33,72,0.458,10,26,0.385,33,36,0.917,129,43,94,0.457,30,60,0.5,13,34,0.382,33,45,0.733,132
1566,2020/3/8,DAL,IND,L 109-112,240,39,91,0.429,25,48,0.521,14,43,0.326,17,25,0.68,109,46,88,0.523,38,65,0.585,8,23,0.348,12,18,0.667,112
1567,2020/3/8,IND,DAL,W 112-109,240,46,88,0.523,38,65,0.585,8,23,0.348,12,18,0.667,112,39,91,0.429,25,48,0.521,14,43,0.326,17,25,0.68,109
1568,2020/3/8,HOU,ORL,L 106-126,240,39,88,0.443,30,56,0.536,9,32,0.281,19,25,0.76,106,44,91,0.484,31,62,0.5,13,29,0.448,25,31,0.806,126
1569,2020/3/8,ORL,HOU,W 126-106,240,44,91,0.484,31,62,0.5,13,29,0.448,25,31,0.806,126,39,88,0.443,30,56,0.536,9,32,0.281,19,25,0.76,106
1570,2020/3/8,LAC,LAL,L 103-112,240,34,86,0.395,27,55,0.491,7,31,0.226,28,37,0.757,103,39,87,0.448,29,52,0.558,10,35,0.286,24,28,0.857,112
1571,2020/3/8,LAL,LAC,W 112-103,240,39,87,0.448,29,52,0.558,10,35,0.286,24,28,0.857,112,34,86,0.395,27,55,0.491,7,31,0.226,28,37,0.757,103
1572,2020/3/8,MIN,NOP,L 107-120,240,37,94,0.394,29,61,0.475,8,33,0.242,25,31,0.806,107,44,90,0.489,33,55,0.6,11,35,0.314,21,31,0.677,120
1573,2020/3/8,NOP,MIN,W 120-107,240,44,90,0.489,33,55,0.6,11,35,0.314,21,31,0.677,120,37,94,0.394,29,61,0.475,8,33,0.242,25,31,0.806,107
1574,2020/3/8,DET,NYK,L 84-96,240,29,80,0.363,18,42,0.429,11,38,0.289,15,22,0.682,84,36,82,0.439,30,63,0.476,6,19,0.316,18,25,0.72,96
1575,2020/3/8,NYK,DET,W 96-84,240,36,82,0.439,30,63,0.476,6,19,0.316,18,25,0.72,96,29,80,0.363,18,42,0.429,11,38,0.289,15,22,0.682,84
1576,2020/3/8,MIL,PHO,L 131-140,240,51,95,0.537,38,62,0.613,13,33,0.394,16,21,0.762,131,47,85,0.553,28,42,0.667,19,43,0.442,27,31,0.871,140
1577,2020/3/8,PHO,MIL,W 140-131,240,47,85,0.553,28,42,0.667,19,43,0.442,27,31,0.871,140,51,95,0.537,38,62,0.613,13,33,0.394,16,21,0.762,131
1578,2020/3/8,SAC,TOR,L 113-118,240,42,90,0.467,34,59,0.576,8,31,0.258,21,23,0.913,113,39,82,0.476,20,34,0.588,19,48,0.396,21,27,0.778,118
1579,2020/3/8,TOR,SAC,W 118-113,240,39,82,0.476,20,34,0.588,19,48,0.396,21,27,0.778,118,42,90,0.467,34,59,0.576,8,31,0.258,21,23,0.913,113
1580,2020/3/8,MIA,WAS,W 100-89,240,32,66,0.485,19,38,0.5,13,28,0.464,23,28,0.821,100,26,78,0.333,7,31,0.226,19,47,0.404,18,21,0.857,89
1581,2020/3/8,WAS,MIA,L 89-100,240,26,78,0.333,7,31,0.226,19,47,0.404,18,21,0.857,89,32,66,0.485,19,38,0.5,13,28,0.464,23,28,0.821,100
1582,2020/3/7,CHO,HOU,W 108-99,240,37,70,0.529,22,38,0.579,15,32,0.469,19,25,0.76,108,35,76,0.461,20,31,0.645,15,45,0.333,14,20,0.7,99
1583,2020/3/7,HOU,CHO,L 99-108,240,35,76,0.461,20,31,0.645,15,45,0.333,14,20,0.7,99,37,70,0.529,22,38,0.579,15,32,0.469,19,25,0.76,108
1584,2020/3/7,CLE,DEN,W 104-102,240,42,76,0.553,30,48,0.625,12,28,0.429,8,12,0.667,104,43,85,0.506,30,53,0.566,13,32,0.406,3,8,0.375,102
1585,2020/3/7,DEN,CLE,L 102-104,240,43,85,0.506,30,53,0.566,13,32,0.406,3,8,0.375,102,42,76,0.553,30,48,0.625,12,28,0.429,8,12,0.667,104
1586,2020/3/7,DET,UTA,L 105-111,240,40,86,0.465,31,56,0.554,9,30,0.3,16,22,0.727,105,40,77,0.519,30,44,0.682,10,33,0.303,21,28,0.75,111
1587,2020/3/7,UTA,DET,W 111-105,240,40,77,0.519,30,44,0.682,10,33,0.303,21,28,0.75,111,40,86,0.465,31,56,0.554,9,30,0.3,16,22,0.727,105
1588,2020/3/7,GSW,PHI,W 118-114,240,44,80,0.55,35,55,0.636,9,25,0.36,21,28,0.75,118,41,84,0.488,28,50,0.56,13,34,0.382,19,22,0.864,114
1589,2020/3/7,PHI,GSW,L 114-118,240,41,84,0.488,28,50,0.56,13,34,0.382,19,22,0.864,114,44,80,0.55,35,55,0.636,9,25,0.36,21,28,0.75,118
1590,2020/3/7,ATL,MEM,L 101-118,240,32,95,0.337,19,46,0.413,13,49,0.265,24,28,0.857,101,43,87,0.494,31,54,0.574,12,33,0.364,20,33,0.606,118
1591,2020/3/7,MEM,ATL,W 118-101,240,43,87,0.494,31,54,0.574,12,33,0.364,20,33,0.606,118,32,95,0.337,19,46,0.413,13,49,0.265,24,28,0.857,101
1592,2020/3/7,POR,SAC,L 111-123,240,42,89,0.472,32,50,0.64,10,39,0.256,17,26,0.654,111,41,85,0.482,20,46,0.435,21,39,0.538,20,23,0.87,123
1593,2020/3/7,SAC,POR,W 123-111,240,41,85,0.482,20,46,0.435,21,39,0.538,20,23,0.87,123,42,89,0.472,32,50,0.64,10,39,0.256,17,26,0.654,111
1594,2020/3/6,BOS,UTA,L 94-99,240,35,94,0.372,25,58,0.431,10,36,0.278,14,18,0.778,94,36,80,0.45,19,35,0.543,17,45,0.378,10,12,0.833,99
1595,2020/3/6,UTA,BOS,W 99-94,240,36,80,0.45,19,35,0.543,17,45,0.378,10,12,0.833,99,35,94,0.372,25,58,0.431,10,36,0.278,14,18,0.778,94
1596,2020/3/6,BRK,SAS,W 139-120,240,51,96,0.531,36,60,0.6,15,36,0.417,22,31,0.71,139,43,92,0.467,33,58,0.569,10,34,0.294,24,27,0.889,120
1597,2020/3/6,SAS,BRK,L 120-139,240,43,92,0.467,33,58,0.569,10,34,0.294,24,27,0.889,120,51,96,0.531,36,60,0.6,15,36,0.417,22,31,0.71,139
1598,2020/3/6,CHI,IND,L 102-108,240,40,97,0.412,31,59,0.525,9,38,0.237,13,15,0.867,102,38,75,0.507,30,53,0.566,8,22,0.364,24,33,0.727,108
1599,2020/3/6,IND,CHI,W 108-102,240,38,75,0.507,30,53,0.566,8,22,0.364,24,33,0.727,108,40,97,0.412,31,59,0.525,9,38,0.237,13,15,0.867,102
1600,2020/3/6,DAL,MEM,W 121-96,240,45,95,0.474,27,48,0.563,18,47,0.383,13,17,0.765,121,39,84,0.464,30,54,0.556,9,30,0.3,9,13,0.692,96
1601,2020/3/6,MEM,DAL,L 96-121,240,39,84,0.464,30,54,0.556,9,30,0.3,9,13,0.692,96,45,95,0.474,27,48,0.563,18,47,0.383,13,17,0.765,121
1602,2020/3/6,LAL,MIL,W 113-103,240,38,91,0.418,32,59,0.542,6,32,0.188,31,38,0.816,113,37,89,0.416,25,46,0.543,12,43,0.279,17,23,0.739,103
1603,2020/3/6,MIL,LAL,L 103-113,240,37,89,0.416,25,46,0.543,12,43,0.279,17,23,0.739,103,38,91,0.418,32,59,0.542,6,32,0.188,31,38,0.816,113
1604,2020/3/6,MIN,ORL,L 118-132,240,46,98,0.469,36,61,0.59,10,37,0.27,16,20,0.8,118,51,84,0.607,44,63,0.698,7,21,0.333,23,31,0.742,132
1605,2020/3/6,ORL,MIN,W 132-118,240,51,84,0.607,44,63,0.698,7,21,0.333,23,31,0.742,132,46,98,0.469,36,61,0.59,10,37,0.27,16,20,0.8,118
1606,2020/3/6,MIA,NOP,L 104-110,240,37,86,0.43,28,53,0.528,9,33,0.273,21,31,0.677,104,38,91,0.418,24,53,0.453,14,38,0.368,20,28,0.714,110
1607,2020/3/6,NOP,MIA,W 110-104,240,38,91,0.418,24,53,0.453,14,38,0.368,20,28,0.714,110,37,86,0.43,28,53,0.528,9,33,0.273,21,31,0.677,104
1608,2020/3/6,NYK,OKC,L 103-126,240,41,91,0.451,37,67,0.552,4,24,0.167,17,22,0.773,103,47,96,0.49,35,65,0.538,12,31,0.387,20,25,0.8,126
1609,2020/3/6,OKC,NYK,W 126-103,240,47,96,0.49,35,65,0.538,12,31,0.387,20,25,0.8,126,41,91,0.451,37,67,0.552,4,24,0.167,17,22,0.773,103
1610,2020/3/6,PHO,POR,W 127-117,240,45,91,0.495,26,49,0.531,19,42,0.452,18,19,0.947,127,43,87,0.494,30,55,0.545,13,32,0.406,18,24,0.75,117
1611,2020/3/6,POR,PHO,L 117-127,240,43,87,0.494,30,55,0.545,13,32,0.406,18,24,0.75,117,45,91,0.495,26,49,0.531,19,42,0.452,18,19,0.947,127
1612,2020/3/6,ATL,WAS,L 112-118,240,46,86,0.535,34,54,0.63,12,32,0.375,8,12,0.667,112,36,76,0.474,21,45,0.467,15,31,0.484,31,35,0.886,118
1613,2020/3/6,WAS,ATL,W 118-112,240,36,76,0.474,21,45,0.467,15,31,0.484,31,35,0.886,118,46,86,0.535,34,54,0.63,12,32,0.375,8,12,0.667,112
1614,2020/3/5,CHO,DEN,L 112-114,240,38,77,0.494,25,44,0.568,13,33,0.394,23,28,0.821,112,44,83,0.53,36,57,0.632,8,26,0.308,18,20,0.9,114
1615,2020/3/5,DEN,CHO,W 114-112,240,44,83,0.53,36,57,0.632,8,26,0.308,18,20,0.9,114,38,77,0.494,25,44,0.568,13,33,0.394,23,28,0.821,112
1616,2020/3/5,GSW,TOR,L 113-121,240,40,98,0.408,26,46,0.565,14,52,0.269,19,25,0.76,113,40,84,0.476,27,43,0.628,13,41,0.317,28,31,0.903,121
1617,2020/3/5,TOR,GSW,W 121-113,240,40,84,0.476,27,43,0.628,13,41,0.317,28,31,0.903,121,40,98,0.408,26,46,0.565,14,52,0.269,19,25,0.76,113
1618,2020/3/5,HOU,LAC,L 105-120,240,35,97,0.361,28,55,0.509,7,42,0.167,28,36,0.778,105,39,84,0.464,26,44,0.591,13,40,0.325,29,39,0.744,120
1619,2020/3/5,LAC,HOU,W 120-105,240,39,84,0.464,26,44,0.591,13,40,0.325,29,39,0.744,120,35,97,0.361,28,55,0.509,7,42,0.167,28,36,0.778,105
1620,2020/3/5,PHI,SAC,W 125-108,240,47,96,0.49,30,59,0.508,17,37,0.459,14,17,0.824,125,42,79,0.532,31,50,0.62,11,29,0.379,13,18,0.722,108
1621,2020/3/5,SAC,PHI,L 108-125,240,42,79,0.532,31,50,0.62,11,29,0.379,13,18,0.722,108,47,96,0.49,30,59,0.508,17,37,0.459,14,17,0.824,125
1622,2020/3/4,BRK,MEM,L 79-118,240,30,90,0.333,23,48,0.479,7,42,0.167,12,17,0.706,79,43,100,0.43,23,56,0.411,20,44,0.455,12,14,0.857,118
1623,2020/3/4,MEM,BRK,W 118-79,240,43,100,0.43,23,56,0.411,20,44,0.455,12,14,0.857,118,30,90,0.333,23,48,0.479,7,42,0.167,12,17,0.706,79
1624,2020/3/4,BOS,CLE,W 112-106,240,40,86,0.465,29,56,0.518,11,30,0.367,21,26,0.808,112,39,89,0.438,26,51,0.51,13,38,0.342,15,20,0.75,106
1625,2020/3/4,CLE,BOS,L 106-112,240,39,89,0.438,26,51,0.51,13,38,0.342,15,20,0.75,106,40,86,0.465,29,56,0.518,11,30,0.367,21,26,0.808,112
1626,2020/3/4,DAL,NOP,W 127-123 (OT),265,44,95,0.463,22,45,0.489,22,50,0.44,17,24,0.708,127,50,114,0.439,33,68,0.485,17,46,0.37,6,11,0.545,123
1627,2020/3/4,NOP,DAL,L 123-127 (OT),265,50,114,0.439,33,68,0.485,17,46,0.37,6,11,0.545,123,44,95,0.463,22,45,0.489,22,50,0.44,17,24,0.708,127
1628,2020/3/4,DET,OKC,L 107-114,240,40,86,0.465,22,43,0.512,18,43,0.419,9,15,0.6,107,46,75,0.613,36,51,0.706,10,24,0.417,12,17,0.706,114
1629,2020/3/4,OKC,DET,W 114-107,240,46,75,0.613,36,51,0.706,10,24,0.417,12,17,0.706,114,40,86,0.465,22,43,0.512,18,43,0.419,9,15,0.6,107
1630,2020/3/4,MIA,ORL,W 116-113,240,41,79,0.519,19,35,0.543,22,44,0.5,12,15,0.8,116,44,84,0.524,31,54,0.574,13,30,0.433,12,14,0.857,113
1631,2020/3/4,ORL,MIA,L 113-116,240,44,84,0.524,31,54,0.574,13,30,0.433,12,14,0.857,113,41,79,0.519,19,35,0.543,22,44,0.5,12,15,0.8,116
1632,2020/3/4,IND,MIL,L 100-119,240,42,97,0.433,35,70,0.5,7,27,0.259,9,11,0.818,100,43,94,0.457,30,48,0.625,13,46,0.283,20,22,0.909,119
1633,2020/3/4,MIL,IND,W 119-100,240,43,94,0.457,30,48,0.625,13,46,0.283,20,22,0.909,119,42,97,0.433,35,70,0.5,7,27,0.259,9,11,0.818,100
1634,2020/3/4,CHI,MIN,L 108-115,240,45,94,0.479,34,64,0.531,11,30,0.367,7,11,0.636,108,40,81,0.494,21,38,0.553,19,43,0.442,16,25,0.64,115
1635,2020/3/4,MIN,CHI,W 115-108,240,40,81,0.494,21,38,0.553,19,43,0.442,16,25,0.64,115,45,94,0.479,34,64,0.531,11,30,0.367,7,11,0.636,108
1636,2020/3/4,NYK,UTA,L 104-112,240,41,85,0.482,34,65,0.523,7,20,0.35,15,18,0.833,104,41,81,0.506,31,45,0.689,10,36,0.278,20,25,0.8,112
1637,2020/3/4,UTA,NYK,W 112-104,240,41,81,0.506,31,45,0.689,10,36,0.278,20,25,0.8,112,41,85,0.482,34,65,0.523,7,20,0.35,15,18,0.833,104
1638,2020/3/4,POR,WAS,W 125-104,240,42,81,0.519,29,50,0.58,13,31,0.419,28,32,0.875,125,40,103,0.388,29,68,0.426,11,35,0.314,13,21,0.619,104
1639,2020/3/4,WAS,POR,L 104-125,240,40,103,0.388,29,68,0.426,11,35,0.314,13,21,0.619,104,42,81,0.519,29,50,0.58,13,31,0.419,28,32,0.875,125
1640,2020/3/3,BOS,BRK,L 120-129 (OT),265,44,103,0.427,29,54,0.537,15,49,0.306,17,23,0.739,120,43,100,0.43,29,51,0.569,14,49,0.286,29,38,0.763,129
1641,2020/3/3,BRK,BOS,W 129-120 (OT),265,43,100,0.43,29,51,0.569,14,49,0.286,29,38,0.763,129,44,103,0.427,29,54,0.537,15,49,0.306,17,23,0.739,120
1642,2020/3/3,CHO,SAS,L 103-104,240,39,82,0.476,27,53,0.509,12,29,0.414,13,18,0.722,103,38,80,0.475,27,48,0.563,11,32,0.344,17,20,0.85,104
1643,2020/3/3,SAS,CHO,W 104-103,240,38,80,0.475,27,48,0.563,11,32,0.344,17,20,0.85,104,39,82,0.476,27,53,0.509,12,29,0.414,13,18,0.722,103
1644,2020/3/3,DEN,GSW,L 100-116,240,39,87,0.448,36,67,0.537,3,20,0.15,19,26,0.731,100,42,82,0.512,24,41,0.585,18,41,0.439,14,22,0.636,116
1645,2020/3/3,GSW,DEN,W 116-100,240,42,82,0.512,24,41,0.585,18,41,0.439,14,22,0.636,116,39,87,0.448,36,67,0.537,3,20,0.15,19,26,0.731,100
1646,2020/3/3,LAL,PHI,W 120-107,240,46,86,0.535,33,53,0.623,13,33,0.394,15,18,0.833,120,38,85,0.447,22,45,0.489,16,40,0.4,15,20,0.75,107
1647,2020/3/3,PHI,LAL,L 107-120,240,38,85,0.447,22,45,0.489,16,40,0.4,15,20,0.75,107,46,86,0.535,33,53,0.623,13,33,0.394,15,18,0.833,120
1648,2020/3/3,MIN,NOP,W 139-134,240,54,97,0.557,40,63,0.635,14,34,0.412,17,20,0.85,139,52,100,0.52,38,61,0.623,14,39,0.359,16,27,0.593,134
1649,2020/3/3,NOP,MIN,L 134-139,240,52,100,0.52,38,61,0.623,14,39,0.359,16,27,0.593,134,54,97,0.557,40,63,0.635,14,34,0.412,17,20,0.85,139
1650,2020/3/3,LAC,OKC,W 109-94,240,38,84,0.452,27,48,0.563,11,36,0.306,22,26,0.846,109,34,81,0.42,25,53,0.472,9,28,0.321,17,26,0.654,94
1651,2020/3/3,OKC,LAC,L 94-109,240,34,81,0.42,25,53,0.472,9,28,0.321,17,26,0.654,94,38,84,0.452,27,48,0.563,11,36,0.306,22,26,0.846,109
1652,2020/3/3,PHO,TOR,L 114-123,240,39,85,0.459,24,46,0.522,15,39,0.385,21,25,0.84,114,40,86,0.465,26,52,0.5,14,34,0.412,29,35,0.829,123
1653,2020/3/3,TOR,PHO,W 123-114,240,40,86,0.465,26,52,0.5,14,34,0.412,29,35,0.829,123,39,85,0.459,24,46,0.522,15,39,0.385,21,25,0.84,114
1654,2020/3/3,SAC,WAS,W 133-126,240,50,89,0.562,37,60,0.617,13,29,0.448,20,24,0.833,133,41,80,0.513,25,42,0.595,16,38,0.421,28,34,0.824,126
1655,2020/3/3,WAS,SAC,L 126-133,240,41,80,0.513,25,42,0.595,16,38,0.421,28,34,0.824,126,50,89,0.562,37,60,0.617,13,29,0.448,20,24,0.833,133
1656,2020/3/2,ATL,MEM,L 88-127,240,32,99,0.323,23,64,0.359,9,35,0.257,15,16,0.938,88,46,92,0.5,32,60,0.533,14,32,0.438,21,31,0.677,127
1657,2020/3/2,MEM,ATL,W 127-88,240,46,92,0.5,32,60,0.533,14,32,0.438,21,31,0.677,127,32,99,0.323,23,64,0.359,9,35,0.257,15,16,0.938,88
1658,2020/3/2,CHI,DAL,W 109-107,240,44,94,0.468,34,58,0.586,10,36,0.278,11,17,0.647,109,40,84,0.476,28,42,0.667,12,42,0.286,15,20,0.75,107
1659,2020/3/2,DAL,CHI,L 107-109,240,40,84,0.476,28,42,0.667,12,42,0.286,15,20,0.75,107,44,94,0.468,34,58,0.586,10,36,0.278,11,17,0.647,109
1660,2020/3/2,CLE,UTA,L 113-126,240,42,91,0.462,25,50,0.5,17,41,0.415,12,18,0.667,113,47,83,0.566,27,42,0.643,20,41,0.488,12,14,0.857,126
1661,2020/3/2,UTA,CLE,W 126-113,240,47,83,0.566,27,42,0.643,20,41,0.488,12,14,0.857,126,42,91,0.462,25,50,0.5,17,41,0.415,12,18,0.667,113
1662,2020/3/2,MIA,MIL,W 105-89,240,37,86,0.43,19,49,0.388,18,37,0.486,13,18,0.722,105,35,86,0.407,28,52,0.538,7,34,0.206,12,19,0.632,89
1663,2020/3/2,MIL,MIA,L 89-105,240,35,86,0.407,28,52,0.538,7,34,0.206,12,19,0.632,89,37,86,0.43,19,49,0.388,18,37,0.486,13,18,0.722,105
1664,2020/3/2,HOU,NYK,L 123-125,240,39,94,0.415,19,38,0.5,20,56,0.357,25,27,0.926,123,47,97,0.485,35,67,0.522,12,30,0.4,19,30,0.633,125
1665,2020/3/2,NYK,HOU,W 125-123,240,47,97,0.485,35,67,0.522,12,30,0.4,19,30,0.633,125,39,94,0.415,19,38,0.5,20,56,0.357,25,27,0.926,123
1666,2020/3/2,ORL,POR,L 107-130,240,37,96,0.385,23,53,0.434,14,43,0.326,19,22,0.864,107,49,88,0.557,33,55,0.6,16,33,0.485,16,16,1,130
1667,2020/3/2,POR,ORL,W 130-107,240,49,88,0.557,33,55,0.6,16,33,0.485,16,16,1,130,37,96,0.385,23,53,0.434,14,43,0.326,19,22,0.864,107
1668,2020/3/2,IND,SAS,W 116-111,240,39,78,0.5,24,47,0.511,15,31,0.484,23,26,0.885,116,40,77,0.519,24,45,0.533,16,32,0.5,15,19,0.789,111
1669,2020/3/2,SAS,IND,L 111-116,240,40,77,0.519,24,45,0.533,16,32,0.5,15,19,0.789,111,39,78,0.5,24,47,0.511,15,31,0.484,23,26,0.885,116
1670,2020/3/1,CHO,MIL,L 85-93,240,34,96,0.354,26,61,0.426,8,35,0.229,9,10,0.9,85,35,87,0.402,28,56,0.5,7,31,0.226,16,21,0.762,93
1671,2020/3/1,MIL,CHO,W 93-85,240,35,87,0.402,28,56,0.5,7,31,0.226,16,21,0.762,93,34,96,0.354,26,61,0.426,8,35,0.229,9,10,0.9,85
1672,2020/3/1,DEN,TOR,W 133-118,240,47,83,0.566,29,47,0.617,18,36,0.5,21,30,0.7,133,41,89,0.461,31,51,0.608,10,38,0.263,26,29,0.897,118
1673,2020/3/1,TOR,DEN,L 118-133,240,41,89,0.461,31,51,0.608,10,38,0.263,26,29,0.897,118,47,83,0.566,29,47,0.617,18,36,0.5,21,30,0.7,133
1674,2020/3/1,GSW,WAS,L 110-124,240,42,89,0.472,33,61,0.541,9,28,0.321,17,24,0.708,110,40,82,0.488,20,52,0.385,20,30,0.667,24,27,0.889,124
1675,2020/3/1,WAS,GSW,W 124-110,240,40,82,0.488,20,52,0.385,20,30,0.667,24,27,0.889,124,42,89,0.472,33,61,0.541,9,28,0.321,17,24,0.708,110
1676,2020/3/1,LAC,PHI,W 136-130,240,45,76,0.592,32,52,0.615,13,24,0.542,33,41,0.805,136,48,95,0.505,27,52,0.519,21,43,0.488,13,20,0.65,130
1677,2020/3/1,PHI,LAC,L 130-136,240,48,95,0.505,27,52,0.519,21,43,0.488,13,20,0.65,130,45,76,0.592,32,52,0.615,13,24,0.542,33,41,0.805,136
1678,2020/3/1,DAL,MIN,W 111-91,240,44,94,0.468,33,54,0.611,11,40,0.275,12,19,0.632,111,36,99,0.364,23,57,0.404,13,42,0.31,6,15,0.4,91
1679,2020/3/1,MIN,DAL,L 91-111,240,36,99,0.364,23,57,0.404,13,42,0.31,6,15,0.4,91,44,94,0.468,33,54,0.611,11,40,0.275,12,19,0.632,111
1680,2020/3/1,LAL,NOP,W 122-114,240,50,97,0.515,37,62,0.597,13,35,0.371,9,10,0.9,122,40,95,0.421,33,63,0.524,7,32,0.219,27,33,0.818,114
1681,2020/3/1,NOP,LAL,L 114-122,240,40,95,0.421,33,63,0.524,7,32,0.219,27,33,0.818,114,50,97,0.515,37,62,0.597,13,35,0.371,9,10,0.9,122
1682,2020/3/1,DET,SAC,L 100-106,240,33,80,0.413,15,38,0.395,18,42,0.429,16,24,0.667,100,37,91,0.407,28,56,0.5,9,35,0.257,23,26,0.885,106
1683,2020/3/1,SAC,DET,W 106-100,240,37,91,0.407,28,56,0.5,9,35,0.257,23,26,0.885,106,33,80,0.413,15,38,0.395,18,42,0.429,16,24,0.667,100
1684,2020/2/29,ATL,POR,W 129-117,240,46,84,0.548,28,42,0.667,18,42,0.429,19,22,0.864,129,47,94,0.5,39,66,0.591,8,28,0.286,15,21,0.714,117
1685,2020/2/29,POR,ATL,L 117-129,240,47,94,0.5,39,66,0.591,8,28,0.286,15,21,0.714,117,46,84,0.548,28,42,0.667,18,42,0.429,19,22,0.864,129
1686,2020/2/29,BOS,HOU,L 110-111 (OT),265,39,100,0.39,26,58,0.448,13,42,0.31,19,25,0.76,110,41,98,0.418,26,43,0.605,15,55,0.273,14,18,0.778,111
1687,2020/2/29,HOU,BOS,W 111-110 (OT),265,41,98,0.418,26,43,0.605,15,55,0.273,14,18,0.778,111,39,100,0.39,26,58,0.448,13,42,0.31,19,25,0.76,110
1688,2020/2/29,CLE,IND,L 104-113,240,41,85,0.482,36,63,0.571,5,22,0.227,17,20,0.85,104,47,87,0.54,39,64,0.609,8,23,0.348,11,14,0.786,113
1689,2020/2/29,IND,CLE,W 113-104,240,47,87,0.54,39,64,0.609,8,23,0.348,11,14,0.786,113,41,85,0.482,36,63,0.571,5,22,0.227,17,20,0.85,104
1690,2020/2/29,LAL,MEM,L 88-105,240,36,87,0.414,27,52,0.519,9,35,0.257,7,12,0.583,88,43,95,0.453,33,64,0.516,10,31,0.323,9,11,0.818,105
1691,2020/2/29,MEM,LAL,W 105-88,240,43,95,0.453,33,64,0.516,10,31,0.323,9,11,0.818,105,36,87,0.414,27,52,0.519,9,35,0.257,7,12,0.583,88
1692,2020/2/29,BRK,MIA,L 113-116,240,40,86,0.465,24,42,0.571,16,44,0.364,17,23,0.739,113,41,91,0.451,27,53,0.509,14,38,0.368,20,24,0.833,116
1693,2020/2/29,MIA,BRK,W 116-113,240,41,91,0.451,27,53,0.509,14,38,0.368,20,24,0.833,116,40,86,0.465,24,42,0.571,16,44,0.364,17,23,0.739,113
1694,2020/2/29,CHI,NYK,L 115-125,240,41,89,0.461,24,54,0.444,17,35,0.486,16,23,0.696,115,47,85,0.553,39,65,0.6,8,20,0.4,23,33,0.697,125
1695,2020/2/29,NYK,CHI,W 125-115,240,47,85,0.553,39,65,0.6,8,20,0.4,23,33,0.697,125,41,89,0.461,24,54,0.444,17,35,0.486,16,23,0.696,115
1696,2020/2/29,GSW,PHO,W 115-99,240,41,87,0.471,32,57,0.561,9,30,0.3,24,32,0.75,115,34,83,0.41,22,54,0.407,12,29,0.414,19,23,0.826,99
1697,2020/2/29,PHO,GSW,L 99-115,240,34,83,0.41,22,54,0.407,12,29,0.414,19,23,0.826,99,41,87,0.471,32,57,0.561,9,30,0.3,24,32,0.75,115
1698,2020/2/29,ORL,SAS,L 113-114,240,41,84,0.488,26,47,0.553,15,37,0.405,16,23,0.696,113,44,84,0.524,30,53,0.566,14,31,0.452,12,16,0.75,114
1699,2020/2/29,SAS,ORL,W 114-113,240,44,84,0.524,30,53,0.566,14,31,0.452,12,16,0.75,114,41,84,0.488,26,47,0.553,15,37,0.405,16,23,0.696,113
1700,2020/2/28,ATL,BRK,W 141-118,240,50,97,0.515,31,58,0.534,19,39,0.487,22,30,0.733,141,42,92,0.457,24,46,0.522,18,46,0.391,16,21,0.762,118
1701,2020/2/28,BRK,ATL,L 118-141,240,42,92,0.457,24,46,0.522,18,46,0.391,16,21,0.762,118,50,97,0.515,31,58,0.534,19,39,0.487,22,30,0.733,141
1702,2020/2/28,DEN,LAC,L 103-132,240,41,91,0.451,32,66,0.485,9,25,0.36,12,16,0.75,103,48,89,0.539,30,50,0.6,18,39,0.462,18,20,0.9,132
1703,2020/2/28,LAC,DEN,W 132-103,240,48,89,0.539,30,50,0.6,18,39,0.462,18,20,0.9,132,41,91,0.451,32,66,0.485,9,25,0.36,12,16,0.75,103
1704,2020/2/28,MEM,SAC,L 101-104,240,39,91,0.429,31,61,0.508,8,30,0.267,15,20,0.75,101,38,91,0.418,27,53,0.509,11,38,0.289,17,21,0.81,104
1705,2020/2/28,SAC,MEM,W 104-101,240,38,91,0.418,27,53,0.509,11,38,0.289,17,21,0.81,104,39,91,0.429,31,61,0.508,8,30,0.267,15,20,0.75,101
1706,2020/2/28,DAL,MIA,L 118-126,240,40,84,0.476,19,34,0.559,21,50,0.42,17,19,0.895,118,41,79,0.519,24,44,0.545,17,35,0.486,27,36,0.75,126
1707,2020/2/28,MIA,DAL,W 126-118,240,41,79,0.519,24,44,0.545,17,35,0.486,27,36,0.75,126,40,84,0.476,19,34,0.559,21,50,0.42,17,19,0.895,118
1708,2020/2/28,MIL,OKC,W 133-86,240,50,100,0.5,29,55,0.527,21,45,0.467,12,14,0.857,133,33,91,0.363,27,56,0.482,6,35,0.171,14,20,0.7,86
1709,2020/2/28,OKC,MIL,L 86-133,240,33,91,0.363,27,56,0.482,6,35,0.171,14,20,0.7,86,50,100,0.5,29,55,0.527,21,45,0.467,12,14,0.857,133
1710,2020/2/28,CLE,NOP,L 104-116,240,43,95,0.453,32,64,0.5,11,31,0.355,7,12,0.583,104,48,88,0.545,39,65,0.6,9,23,0.391,11,15,0.733,116
1711,2020/2/28,NOP,CLE,W 116-104,240,48,88,0.545,39,65,0.6,9,23,0.391,11,15,0.733,116,43,95,0.453,32,64,0.5,11,31,0.355,7,12,0.583,104
1712,2020/2/28,MIN,ORL,L 125-136,240,46,95,0.484,29,51,0.569,17,44,0.386,16,24,0.667,125,53,98,0.541,41,58,0.707,12,40,0.3,18,22,0.818,136
1713,2020/2/28,ORL,MIN,W 136-125,240,53,98,0.541,41,58,0.707,12,40,0.3,18,22,0.818,136,46,95,0.484,29,51,0.569,17,44,0.386,16,24,0.667,125
1714,2020/2/28,DET,PHO,W 113-111,240,44,90,0.489,31,58,0.534,13,32,0.406,12,16,0.75,113,45,75,0.6,36,52,0.692,9,23,0.391,12,17,0.706,111
1715,2020/2/28,PHO,DET,L 111-113,240,45,75,0.6,36,52,0.692,9,23,0.391,12,17,0.706,111,44,90,0.489,31,58,0.534,13,32,0.406,12,16,0.75,113
1716,2020/2/28,CHO,TOR,W 99-96,240,34,78,0.436,21,48,0.438,13,30,0.433,18,25,0.72,99,33,95,0.347,23,52,0.442,10,43,0.233,20,29,0.69,96
1717,2020/2/28,TOR,CHO,L 96-99,240,33,95,0.347,23,52,0.442,10,43,0.233,20,29,0.69,96,34,78,0.436,21,48,0.438,13,30,0.433,18,25,0.72,99
1718,2020/2/28,UTA,WAS,W 129-119,240,44,89,0.494,25,52,0.481,19,37,0.514,22,30,0.733,129,45,98,0.459,31,61,0.508,14,37,0.378,15,21,0.714,119
1719,2020/2/28,WAS,UTA,L 119-129,240,45,98,0.459,31,61,0.508,14,37,0.378,15,21,0.714,119,44,89,0.494,25,52,0.481,19,37,0.514,22,30,0.733,129
1720,2020/2/27,GSW,LAL,L 86-116,240,34,80,0.425,25,48,0.521,9,32,0.281,9,10,0.9,86,45,88,0.511,37,64,0.578,8,24,0.333,18,27,0.667,116
1721,2020/2/27,LAL,GSW,W 116-86,240,45,88,0.511,37,64,0.578,8,24,0.333,18,27,0.667,116,34,80,0.425,25,48,0.521,9,32,0.281,9,10,0.9,86
1722,2020/2/27,IND,POR,W 106-100,240,40,90,0.444,32,65,0.492,8,25,0.32,18,23,0.783,106,41,89,0.461,32,59,0.542,9,30,0.3,9,14,0.643,100
1723,2020/2/27,POR,IND,L 100-106,240,41,89,0.461,32,59,0.542,9,30,0.3,9,14,0.643,100,40,90,0.444,32,65,0.492,8,25,0.32,18,23,0.783,106
1724,2020/2/27,OKC,SAC,W 112-108,240,41,84,0.488,32,58,0.552,9,26,0.346,21,29,0.724,112,41,91,0.451,29,56,0.518,12,35,0.343,14,14,1,108
1725,2020/2/27,SAC,OKC,L 108-112,240,41,91,0.451,29,56,0.518,12,35,0.343,14,14,1,108,41,84,0.488,32,58,0.552,9,26,0.346,21,29,0.724,112
1726,2020/2/27,NYK,PHI,L 106-115,240,42,83,0.506,34,60,0.567,8,23,0.348,14,24,0.583,106,45,91,0.495,30,60,0.5,15,31,0.484,10,13,0.769,115
1727,2020/2/27,PHI,NYK,W 115-106,240,45,91,0.495,30,60,0.5,15,31,0.484,10,13,0.769,115,42,83,0.506,34,60,0.567,8,23,0.348,14,24,0.583,106
1728,2020/2/26,ATL,ORL,L 120-130,240,42,94,0.447,29,58,0.5,13,36,0.361,23,25,0.92,120,49,100,0.49,35,68,0.515,14,32,0.438,18,25,0.72,130
1729,2020/2/26,ORL,ATL,W 130-120,240,49,100,0.49,35,68,0.515,14,32,0.438,18,25,0.72,130,42,94,0.447,29,58,0.5,13,36,0.361,23,25,0.92,120
1730,2020/2/26,CHO,NYK,W 107-101,240,39,83,0.47,29,53,0.547,10,30,0.333,19,25,0.76,107,43,85,0.506,39,70,0.557,4,15,0.267,11,17,0.647,101
1731,2020/2/26,NYK,CHO,L 101-107,240,43,85,0.506,39,70,0.557,4,15,0.267,11,17,0.647,101,39,83,0.47,29,53,0.547,10,30,0.333,19,25,0.76,107
1732,2020/2/26,CLE,PHI,W 108-94,240,41,78,0.526,30,54,0.556,11,24,0.458,15,17,0.882,108,36,89,0.404,23,51,0.451,13,38,0.342,9,14,0.643,94
1733,2020/2/26,PHI,CLE,L 94-108,240,36,89,0.404,23,51,0.451,13,38,0.342,9,14,0.643,94,41,78,0.526,30,54,0.556,11,24,0.458,15,17,0.882,108
1734,2020/2/26,HOU,MEM,W 140-112,240,52,93,0.559,29,43,0.674,23,50,0.46,13,15,0.867,140,43,108,0.398,30,69,0.435,13,39,0.333,13,21,0.619,112
1735,2020/2/26,MEM,HOU,L 112-140,240,43,108,0.398,30,69,0.435,13,39,0.333,13,21,0.619,112,52,93,0.559,29,43,0.674,23,50,0.46,13,15,0.867,140
1736,2020/2/26,MIA,MIN,L 126-129,240,41,78,0.526,30,52,0.577,11,26,0.423,33,43,0.767,126,47,91,0.516,30,45,0.667,17,46,0.37,18,25,0.72,129
1737,2020/2/26,MIN,MIA,W 129-126,240,47,91,0.516,30,45,0.667,17,46,0.37,18,25,0.72,129,41,78,0.526,30,52,0.577,11,26,0.423,33,43,0.767,126
1738,2020/2/26,LAC,PHO,W 102-92,240,37,84,0.44,23,46,0.5,14,38,0.368,14,15,0.933,102,34,87,0.391,25,53,0.472,9,34,0.265,15,18,0.833,92
1739,2020/2/26,PHO,LAC,L 92-102,240,34,87,0.391,25,53,0.472,9,34,0.265,15,18,0.833,92,37,84,0.44,23,46,0.5,14,38,0.368,14,15,0.933,102
1740,2020/2/26,DAL,SAS,W 109-103,240,36,86,0.419,19,41,0.463,17,45,0.378,20,30,0.667,109,39,92,0.424,28,59,0.475,11,33,0.333,14,19,0.737,103
1741,2020/2/26,SAS,DAL,L 103-109,240,39,92,0.424,28,59,0.475,11,33,0.333,14,19,0.737,103,36,86,0.419,19,41,0.463,17,45,0.378,20,30,0.667,109
1742,2020/2/26,BOS,UTA,W 114-103,240,45,84,0.536,34,58,0.586,11,26,0.423,13,16,0.813,114,40,89,0.449,28,49,0.571,12,40,0.3,11,15,0.733,103
1743,2020/2/26,UTA,BOS,L 103-114,240,40,89,0.449,28,49,0.571,12,40,0.3,11,15,0.733,103,45,84,0.536,34,58,0.586,11,26,0.423,13,16,0.813,114
1744,2020/2/26,BRK,WAS,L 106-110,240,36,87,0.414,26,51,0.51,10,36,0.278,24,35,0.686,106,41,96,0.427,26,57,0.456,15,39,0.385,13,16,0.813,110
1745,2020/2/26,WAS,BRK,W 110-106,240,41,96,0.427,26,57,0.456,15,39,0.385,13,16,0.813,110,36,87,0.414,26,51,0.51,10,36,0.278,24,35,0.686,106
1746,2020/2/25,CHI,OKC,L 122-124,240,52,97,0.536,40,66,0.606,12,31,0.387,6,9,0.667,122,42,76,0.553,28,46,0.609,14,30,0.467,26,35,0.743,124
1747,2020/2/25,OKC,CHI,W 124-122,240,42,76,0.553,28,46,0.609,14,30,0.467,26,35,0.743,124,52,97,0.536,40,66,0.606,12,31,0.387,6,9,0.667,122
1748,2020/2/25,DEN,DET,W 115-98,240,44,76,0.579,35,57,0.614,9,19,0.474,18,22,0.818,115,33,81,0.407,18,40,0.45,15,41,0.366,17,21,0.81,98
1749,2020/2/25,DET,DEN,L 98-115,240,33,81,0.407,18,40,0.45,15,41,0.366,17,21,0.81,98,44,76,0.579,35,57,0.614,9,19,0.474,18,22,0.818,115
1750,2020/2/25,GSW,SAC,L 94-112,240,35,79,0.443,31,51,0.608,4,28,0.143,20,24,0.833,94,40,76,0.526,27,46,0.587,13,30,0.433,19,34,0.559,112
1751,2020/2/25,SAC,GSW,W 112-94,240,40,76,0.526,27,46,0.587,13,30,0.433,19,34,0.559,112,35,79,0.443,31,51,0.608,4,28,0.143,20,24,0.833,94
1752,2020/2/25,CHO,IND,L 80-119,240,31,93,0.333,21,60,0.35,10,33,0.303,8,18,0.444,80,49,86,0.57,39,63,0.619,10,23,0.435,11,13,0.846,119
1753,2020/2/25,IND,CHO,W 119-80,240,49,86,0.57,39,63,0.619,10,23,0.435,11,13,0.846,119,31,93,0.333,21,60,0.35,10,33,0.303,8,18,0.444,80
1754,2020/2/25,LAL,NOP,W 118-109,240,45,102,0.441,32,58,0.552,13,44,0.295,15,21,0.714,118,39,86,0.453,31,59,0.525,8,27,0.296,23,30,0.767,109
1755,2020/2/25,NOP,LAL,L 109-118,240,39,86,0.453,31,59,0.525,8,27,0.296,23,30,0.767,109,45,102,0.441,32,58,0.552,13,44,0.295,15,21,0.714,118
1756,2020/2/25,BOS,POR,W 118-106,240,43,90,0.478,24,51,0.471,19,39,0.487,13,14,0.929,118,38,85,0.447,25,54,0.463,13,31,0.419,17,23,0.739,106
1757,2020/2/25,POR,BOS,L 106-118,240,38,85,0.447,25,54,0.463,13,31,0.419,17,23,0.739,106,43,90,0.478,24,51,0.471,19,39,0.487,13,14,0.929,118
1758,2020/2/25,MIL,TOR,W 108-97,240,32,84,0.381,18,42,0.429,14,42,0.333,30,36,0.833,108,32,91,0.352,14,39,0.359,18,52,0.346,15,21,0.714,97
1759,2020/2/25,TOR,MIL,L 97-108,240,32,91,0.352,14,39,0.359,18,52,0.346,15,21,0.714,97,32,84,0.381,18,42,0.429,14,42,0.333,30,36,0.833,108
1760,2020/2/24,BRK,ORL,L 113-115,240,46,96,0.479,30,59,0.508,16,37,0.432,5,8,0.625,113,44,89,0.494,31,55,0.564,13,34,0.382,14,17,0.824,115
1761,2020/2/24,ORL,BRK,W 115-113,240,44,89,0.494,31,55,0.564,13,34,0.382,14,17,0.824,115,46,96,0.479,30,59,0.508,16,37,0.432,5,8,0.625,113
1762,2020/2/24,CLE,MIA,W 125-119 (OT),265,43,97,0.443,29,60,0.483,14,37,0.378,25,34,0.735,125,44,96,0.458,28,54,0.519,16,42,0.381,15,20,0.75,119
1763,2020/2/24,MIA,CLE,L 119-125 (OT),265,44,96,0.458,28,54,0.519,16,42,0.381,15,20,0.75,119,43,97,0.443,29,60,0.483,14,37,0.378,25,34,0.735,125
1764,2020/2/24,DAL,MIN,W 139-123,240,51,101,0.505,35,57,0.614,16,44,0.364,21,28,0.75,139,42,95,0.442,27,53,0.509,15,42,0.357,24,34,0.706,123
1765,2020/2/24,MIN,DAL,L 123-139,240,42,95,0.442,27,53,0.509,15,42,0.357,24,34,0.706,123,51,101,0.505,35,57,0.614,16,44,0.364,21,28,0.75,139
1766,2020/2/24,HOU,NYK,W 123-112,240,43,86,0.5,27,38,0.711,16,48,0.333,21,31,0.677,123,40,91,0.44,29,62,0.468,11,29,0.379,21,30,0.7,112
1767,2020/2/24,NYK,HOU,L 112-123,240,40,91,0.44,29,62,0.468,11,29,0.379,21,30,0.7,112,43,86,0.5,27,38,0.711,16,48,0.333,21,31,0.677,123
1768,2020/2/24,LAC,MEM,W 124-97,240,47,94,0.5,31,57,0.544,16,37,0.432,14,17,0.824,124,37,89,0.416,30,62,0.484,7,27,0.259,16,22,0.727,97
1769,2020/2/24,MEM,LAC,L 97-124,240,37,89,0.416,30,62,0.484,7,27,0.259,16,22,0.727,97,47,94,0.5,31,57,0.544,16,37,0.432,14,17,0.824,124
1770,2020/2/24,ATL,PHI,L 112-129,240,40,97,0.412,32,59,0.542,8,38,0.211,24,27,0.889,112,45,88,0.511,33,58,0.569,12,30,0.4,27,30,0.9,129
1771,2020/2/24,PHI,ATL,W 129-112,240,45,88,0.511,33,58,0.569,12,30,0.4,27,30,0.9,129,40,97,0.412,32,59,0.542,8,38,0.211,24,27,0.889,112
1772,2020/2/24,PHO,UTA,W 131-111,240,49,87,0.563,37,67,0.552,12,20,0.6,21,24,0.875,131,32,68,0.471,22,42,0.524,10,26,0.385,37,43,0.86,111
1773,2020/2/24,UTA,PHO,L 111-131,240,32,68,0.471,22,42,0.524,10,26,0.385,37,43,0.86,111,49,87,0.563,37,67,0.552,12,20,0.6,21,24,0.875,131
1774,2020/2/24,MIL,WAS,W 137-134 (OT),265,49,86,0.57,32,49,0.653,17,37,0.459,22,27,0.815,137,47,98,0.48,32,63,0.508,15,35,0.429,25,33,0.758,134
1775,2020/2/24,WAS,MIL,L 134-137 (OT),265,47,98,0.48,32,63,0.508,15,35,0.429,25,33,0.758,134,49,86,0.57,32,49,0.653,17,37,0.459,22,27,0.815,137
1776,2020/2/23,CHI,WAS,W 126-117,240,45,81,0.556,27,44,0.614,18,37,0.486,18,28,0.643,126,37,73,0.507,25,43,0.581,12,30,0.4,31,36,0.861,117
1777,2020/2/23,WAS,CHI,L 117-126,240,37,73,0.507,25,43,0.581,12,30,0.4,31,36,0.861,117,45,81,0.556,27,44,0.614,18,37,0.486,18,28,0.643,126
1778,2020/2/23,DEN,MIN,W 128-116,240,53,90,0.589,42,60,0.7,11,30,0.367,11,17,0.647,128,40,90,0.444,26,50,0.52,14,40,0.35,22,29,0.759,116
1779,2020/2/23,MIN,DEN,L 116-128,240,40,90,0.444,26,50,0.52,14,40,0.35,22,29,0.759,116,53,90,0.589,42,60,0.7,11,30,0.367,11,17,0.647,128
1780,2020/2/23,GSW,NOP,L 101-115,240,40,92,0.435,29,57,0.509,11,35,0.314,10,15,0.667,101,46,98,0.469,29,56,0.518,17,42,0.405,6,13,0.462,115
1781,2020/2/23,NOP,GSW,W 115-101,240,46,98,0.469,29,56,0.518,17,42,0.405,6,13,0.462,115,40,92,0.435,29,57,0.509,11,35,0.314,10,15,0.667,101
1782,2020/2/23,BOS,LAL,L 112-114,240,38,83,0.458,25,49,0.51,13,34,0.382,23,30,0.767,112,39,86,0.453,28,52,0.538,11,34,0.324,25,37,0.676,114
1783,2020/2/23,LAL,BOS,W 114-112,240,39,86,0.453,28,52,0.538,11,34,0.324,25,37,0.676,114,38,83,0.458,25,49,0.51,13,34,0.382,23,30,0.767,112
1784,2020/2/23,OKC,SAS,W 131-103,240,50,87,0.575,40,65,0.615,10,22,0.455,21,24,0.875,131,38,103,0.369,27,65,0.415,11,38,0.289,16,19,0.842,103
1785,2020/2/23,SAS,OKC,L 103-131,240,38,103,0.369,27,65,0.415,11,38,0.289,16,19,0.842,103,50,87,0.575,40,65,0.615,10,22,0.455,21,24,0.875,131
1786,2020/2/23,DET,POR,L 104-107,240,37,86,0.43,26,51,0.51,11,35,0.314,19,20,0.95,104,41,84,0.488,28,54,0.519,13,30,0.433,12,19,0.632,107
1787,2020/2/23,POR,DET,W 107-104,240,41,84,0.488,28,54,0.519,13,30,0.433,12,19,0.632,107,37,86,0.43,26,51,0.51,11,35,0.314,19,20,0.95,104
1788,2020/2/23,IND,TOR,L 81-127,240,31,95,0.326,23,62,0.371,8,33,0.242,11,17,0.647,81,47,92,0.511,30,48,0.625,17,44,0.386,16,18,0.889,127
1789,2020/2/23,TOR,IND,W 127-81,240,47,92,0.511,30,48,0.625,17,44,0.386,16,18,0.889,127,31,95,0.326,23,62,0.371,8,33,0.242,11,17,0.647,81
1790,2020/2/22,ATL,DAL,W 111-107,240,43,98,0.439,35,61,0.574,8,37,0.216,17,26,0.654,111,40,89,0.449,26,45,0.578,14,44,0.318,13,19,0.684,107
1791,2020/2/22,DAL,ATL,L 107-111,240,40,89,0.449,26,45,0.578,14,44,0.318,13,19,0.684,107,43,98,0.439,35,61,0.574,8,37,0.216,17,26,0.654,111
1792,2020/2/22,CHI,PHO,L 104-112,240,36,83,0.434,22,45,0.489,14,38,0.368,18,21,0.857,104,38,86,0.442,28,56,0.5,10,30,0.333,26,31,0.839,112
1793,2020/2/22,PHO,CHI,W 112-104,240,38,86,0.442,28,56,0.5,10,30,0.333,26,31,0.839,112,36,83,0.434,22,45,0.489,14,38,0.368,18,21,0.857,104
1794,2020/2/22,BRK,CHO,W 115-86,240,42,87,0.483,25,40,0.625,17,47,0.362,14,19,0.737,115,31,88,0.352,19,53,0.358,12,35,0.343,12,21,0.571,86
1795,2020/2/22,CHO,BRK,L 86-115,240,31,88,0.352,19,53,0.358,12,35,0.343,12,21,0.571,86,42,87,0.483,25,40,0.625,17,47,0.362,14,19,0.737,115
1796,2020/2/22,LAC,SAC,L 103-112,240,34,87,0.391,24,57,0.421,10,30,0.333,25,29,0.862,103,40,89,0.449,28,58,0.483,12,31,0.387,20,26,0.769,112
1797,2020/2/22,SAC,LAC,W 112-103,240,40,89,0.449,28,58,0.483,12,31,0.387,20,26,0.769,112,34,87,0.391,24,57,0.421,10,30,0.333,25,29,0.862,103
1798,2020/2/22,CLE,MIA,L 105-124,240,38,79,0.481,25,43,0.581,13,36,0.361,16,22,0.727,105,45,79,0.57,26,39,0.667,19,40,0.475,15,20,0.75,124
1799,2020/2/22,MIA,CLE,W 124-105,240,45,79,0.57,26,39,0.667,19,40,0.475,15,20,0.75,124,38,79,0.481,25,43,0.581,13,36,0.361,16,22,0.727,105
1800,2020/2/22,MIL,PHI,W 119-98,240,48,91,0.527,34,50,0.68,14,41,0.341,9,13,0.692,119,35,99,0.354,22,61,0.361,13,38,0.342,15,18,0.833,98
1801,2020/2/22,PHI,MIL,L 98-119,240,35,99,0.354,22,61,0.361,13,38,0.342,15,18,0.833,98,48,91,0.527,34,50,0.68,14,41,0.341,9,13,0.692,119
1802,2020/2/22,HOU,UTA,W 120-110,240,45,92,0.489,25,44,0.568,20,48,0.417,10,14,0.714,120,42,90,0.467,35,59,0.593,7,31,0.226,19,24,0.792,110
1803,2020/2/22,UTA,HOU,L 110-120,240,42,90,0.467,35,59,0.593,7,31,0.226,19,24,0.792,110,45,92,0.489,25,44,0.568,20,48,0.417,10,14,0.714,120
1804,2020/2/21,LAL,MEM,W 117-105,240,41,86,0.477,32,57,0.561,9,29,0.31,26,40,0.65,117,42,92,0.457,37,77,0.481,5,15,0.333,16,31,0.516,105
1805,2020/2/21,MEM,LAL,L 105-117,240,42,92,0.457,37,77,0.481,5,15,0.333,16,31,0.516,105,41,86,0.477,32,57,0.561,9,29,0.31,26,40,0.65,117
1806,2020/2/21,BOS,MIN,W 127-117,240,44,95,0.463,34,66,0.515,10,29,0.345,29,37,0.784,127,36,89,0.404,21,47,0.447,15,42,0.357,30,35,0.857,117
1807,2020/2/21,MIN,BOS,L 117-127,240,36,89,0.404,21,47,0.447,15,42,0.357,30,35,0.857,117,44,95,0.463,34,66,0.515,10,29,0.345,29,37,0.784,127
1808,2020/2/21,IND,NYK,W 106-98,240,36,88,0.409,28,60,0.467,8,28,0.286,26,33,0.788,106,35,81,0.432,24,56,0.429,11,25,0.44,17,25,0.68,98
1809,2020/2/21,NYK,IND,L 98-106,240,35,81,0.432,24,56,0.429,11,25,0.44,17,25,0.68,98,36,88,0.409,28,60,0.467,8,28,0.286,26,33,0.788,106
1810,2020/2/21,DEN,OKC,L 101-113,240,37,77,0.481,31,50,0.62,6,27,0.222,21,23,0.913,101,40,87,0.46,31,61,0.508,9,26,0.346,24,27,0.889,113
1811,2020/2/21,OKC,DEN,W 113-101,240,40,87,0.46,31,61,0.508,9,26,0.346,24,27,0.889,113,37,77,0.481,31,50,0.62,6,27,0.222,21,23,0.913,101
1812,2020/2/21,DAL,ORL,W 122-106,240,43,84,0.512,28,46,0.609,15,38,0.395,21,26,0.808,122,41,104,0.394,32,61,0.525,9,43,0.209,15,19,0.789,106
1813,2020/2/21,ORL,DAL,L 106-122,240,41,104,0.394,32,61,0.525,9,43,0.209,15,19,0.789,106,43,84,0.512,28,46,0.609,15,38,0.395,21,26,0.808,122
1814,2020/2/21,NOP,POR,W 128-115,240,45,84,0.536,27,50,0.54,18,34,0.529,20,33,0.606,128,43,94,0.457,33,67,0.493,10,27,0.37,19,25,0.76,115
1815,2020/2/21,POR,NOP,L 115-128,240,43,94,0.457,33,67,0.493,10,27,0.37,19,25,0.76,115,45,84,0.536,27,50,0.54,18,34,0.529,20,33,0.606,128
1816,2020/2/21,PHO,TOR,L 101-118,240,38,92,0.413,32,58,0.552,6,34,0.176,19,23,0.826,101,42,80,0.525,28,43,0.651,14,37,0.378,20,22,0.909,118
1817,2020/2/21,TOR,PHO,W 118-101,240,42,80,0.525,28,43,0.651,14,37,0.378,20,22,0.909,118,38,92,0.413,32,58,0.552,6,34,0.176,19,23,0.826,101
1818,2020/2/21,SAS,UTA,W 113-104,240,40,91,0.44,30,71,0.423,10,20,0.5,23,26,0.885,113,35,82,0.427,23,49,0.469,12,33,0.364,22,26,0.846,104
1819,2020/2/21,UTA,SAS,L 104-113,240,35,82,0.427,23,49,0.469,12,33,0.364,22,26,0.846,104,40,91,0.44,30,71,0.423,10,20,0.5,23,26,0.885,113
1820,2020/2/21,CLE,WAS,W 113-108,240,43,81,0.531,32,54,0.593,11,27,0.407,16,25,0.64,113,41,106,0.387,32,69,0.464,9,37,0.243,17,23,0.739,108
1821,2020/2/21,WAS,CLE,L 108-113,240,41,106,0.387,32,69,0.464,9,37,0.243,17,23,0.739,108,43,81,0.531,32,54,0.593,11,27,0.407,16,25,0.64,113
1822,2020/2/20,ATL,MIA,W 129-124,240,41,85,0.482,25,50,0.5,16,35,0.457,31,35,0.886,129,40,98,0.408,29,61,0.475,11,37,0.297,33,38,0.868,124
1823,2020/2/20,MIA,ATL,L 124-129,240,40,98,0.408,29,61,0.475,11,37,0.297,33,38,0.868,124,41,85,0.482,25,50,0.5,16,35,0.457,31,35,0.886,129
1824,2020/2/20,CHI,CHO,L 93-103,240,37,87,0.425,30,56,0.536,7,31,0.226,12,19,0.632,93,35,74,0.473,27,46,0.587,8,28,0.286,25,29,0.862,103
1825,2020/2/20,CHO,CHI,W 103-93,240,35,74,0.473,27,46,0.587,8,28,0.286,25,29,0.862,103,37,87,0.425,30,56,0.536,7,31,0.226,12,19,0.632,93
1826,2020/2/20,DET,MIL,L 106-126,240,40,83,0.482,27,46,0.587,13,37,0.351,13,16,0.813,106,47,93,0.505,37,60,0.617,10,33,0.303,22,27,0.815,126
1827,2020/2/20,MIL,DET,W 126-106,240,47,93,0.505,37,60,0.617,10,33,0.303,22,27,0.815,126,40,83,0.482,27,46,0.587,13,37,0.351,13,16,0.813,106
1828,2020/2/20,GSW,HOU,L 105-135,240,44,89,0.494,37,56,0.661,7,33,0.212,10,12,0.833,105,45,85,0.529,20,36,0.556,25,49,0.51,20,22,0.909,135
1829,2020/2/20,HOU,GSW,W 135-105,240,45,85,0.529,20,36,0.556,25,49,0.51,20,22,0.909,135,44,89,0.494,37,56,0.661,7,33,0.212,10,12,0.833,105
1830,2020/2/20,BRK,PHI,L 104-112 (OT),265,36,102,0.353,26,68,0.382,10,34,0.294,22,28,0.786,104,38,86,0.442,34,64,0.531,4,22,0.182,32,35,0.914,112
1831,2020/2/20,PHI,BRK,W 112-104 (OT),265,38,86,0.442,34,64,0.531,4,22,0.182,32,35,0.914,112,36,102,0.353,26,68,0.382,10,34,0.294,22,28,0.786,104
1832,2020/2/20,MEM,SAC,L 125-129,240,43,85,0.506,31,55,0.564,12,30,0.4,27,32,0.844,125,42,83,0.506,23,44,0.523,19,39,0.487,26,36,0.722,129
1833,2020/2/20,SAC,MEM,W 129-125,240,42,83,0.506,23,44,0.523,19,39,0.487,26,36,0.722,129,43,85,0.506,31,55,0.564,12,30,0.4,27,32,0.844,125
1834,2020/2/13,BOS,LAC,W 141-133 (2OT),290,45,103,0.437,27,60,0.45,18,43,0.419,33,40,0.825,141,46,110,0.418,35,75,0.467,11,35,0.314,30,37,0.811,133
1835,2020/2/13,LAC,BOS,L 133-141 (2OT),290,46,110,0.418,35,75,0.467,11,35,0.314,30,37,0.811,133,45,103,0.437,27,60,0.45,18,43,0.419,33,40,0.825,141
1836,2020/2/13,NOP,OKC,L 118-123,240,42,86,0.488,28,51,0.549,14,35,0.4,20,27,0.741,118,46,92,0.5,33,65,0.508,13,27,0.481,18,22,0.818,123
1837,2020/2/13,OKC,NOP,W 123-118,240,46,92,0.5,33,65,0.508,13,27,0.481,18,22,0.818,123,42,86,0.488,28,51,0.549,14,35,0.4,20,27,0.741,118
1838,2020/2/12,BRK,TOR,W 101-91,240,36,88,0.409,27,53,0.509,9,35,0.257,20,25,0.8,101,34,90,0.378,21,47,0.447,13,43,0.302,10,13,0.769,91
1839,2020/2/12,TOR,BRK,L 91-101,240,34,90,0.378,21,47,0.447,13,43,0.302,10,13,0.769,91,36,88,0.409,27,53,0.509,9,35,0.257,20,25,0.8,101
1840,2020/2/12,ATL,CLE,L 105-127,240,36,84,0.429,23,50,0.46,13,34,0.382,20,25,0.8,105,48,94,0.511,38,66,0.576,10,28,0.357,21,25,0.84,127
1841,2020/2/12,CLE,ATL,W 127-105,240,48,94,0.511,38,66,0.576,10,28,0.357,21,25,0.84,127,36,84,0.429,23,50,0.46,13,34,0.382,20,25,0.8,105
1842,2020/2/12,DAL,SAC,W 130-111,240,48,85,0.565,31,45,0.689,17,40,0.425,17,21,0.81,130,41,99,0.414,29,60,0.483,12,39,0.308,17,22,0.773,111
1843,2020/2/12,SAC,DAL,L 111-130,240,41,99,0.414,29,60,0.483,12,39,0.308,17,22,0.773,111,48,85,0.565,31,45,0.689,17,40,0.425,17,21,0.81,130
1844,2020/2/12,DEN,LAL,L 116-120 (OT),265,44,88,0.5,33,63,0.524,11,25,0.44,17,22,0.773,116,47,93,0.505,35,60,0.583,12,33,0.364,14,27,0.519,120
1845,2020/2/12,LAL,DEN,W 120-116 (OT),265,47,93,0.505,35,60,0.583,12,33,0.364,14,27,0.519,120,44,88,0.5,33,63,0.524,11,25,0.44,17,22,0.773,116
1846,2020/2/12,IND,MIL,W 118-111,240,45,86,0.523,36,59,0.61,9,27,0.333,19,24,0.792,118,37,91,0.407,24,54,0.444,13,37,0.351,24,25,0.96,111
1847,2020/2/12,MIL,IND,L 111-118,240,37,91,0.407,24,54,0.444,13,37,0.351,24,25,0.96,111,45,86,0.523,36,59,0.61,9,27,0.333,19,24,0.792,118
1848,2020/2/12,MEM,POR,W 111-104,240,45,95,0.474,39,72,0.542,6,23,0.261,15,22,0.682,111,36,97,0.371,23,60,0.383,13,37,0.351,19,24,0.792,104
1849,2020/2/12,POR,MEM,L 104-111,240,36,97,0.371,23,60,0.383,13,37,0.351,19,24,0.792,104,45,95,0.474,39,72,0.542,6,23,0.261,15,22,0.682,111
1850,2020/2/12,CHO,MIN,W 115-108,240,43,92,0.467,29,58,0.5,14,34,0.412,15,23,0.652,115,39,101,0.386,25,52,0.481,14,49,0.286,16,20,0.8,108
1851,2020/2/12,MIN,CHO,L 108-115,240,39,101,0.386,25,52,0.481,14,49,0.286,16,20,0.8,108,43,92,0.467,29,58,0.5,14,34,0.412,15,23,0.652,115
1852,2020/2/12,NYK,WAS,L 96-114,240,36,88,0.409,33,65,0.508,3,23,0.13,21,29,0.724,96,40,84,0.476,30,56,0.536,10,28,0.357,24,33,0.727,114
1853,2020/2/12,WAS,NYK,W 114-96,240,40,84,0.476,30,56,0.536,10,28,0.357,24,33,0.727,114,36,88,0.409,33,65,0.508,3,23,0.13,21,29,0.724,96
1854,2020/2/12,DET,ORL,L 112-116 (OT),265,40,92,0.435,22,47,0.468,18,45,0.4,14,15,0.933,112,44,96,0.458,32,60,0.533,12,36,0.333,16,18,0.889,116
1855,2020/2/12,ORL,DET,W 116-112 (OT),265,44,96,0.458,32,60,0.533,12,36,0.333,16,18,0.889,116,40,92,0.435,22,47,0.468,18,45,0.4,14,15,0.933,112
1856,2020/2/12,GSW,PHO,L 106-112,240,39,77,0.506,28,46,0.609,11,31,0.355,17,19,0.895,106,42,91,0.462,28,54,0.519,14,37,0.378,14,15,0.933,112
1857,2020/2/12,PHO,GSW,W 112-106,240,42,91,0.462,28,54,0.519,14,37,0.378,14,15,0.933,112,39,77,0.506,28,46,0.609,11,31,0.355,17,19,0.895,106
1858,2020/2/12,MIA,UTA,L 101-116,240,38,88,0.432,25,49,0.51,13,39,0.333,12,16,0.75,101,41,85,0.482,27,49,0.551,14,36,0.389,20,23,0.87,116
1859,2020/2/12,UTA,MIA,W 116-101,240,41,85,0.482,27,49,0.551,14,36,0.389,20,23,0.87,116,38,88,0.432,25,49,0.51,13,39,0.333,12,16,0.75,101
1860,2020/2/11,BOS,HOU,L 105-116,240,37,85,0.435,26,53,0.491,11,32,0.344,20,25,0.8,105,33,77,0.429,20,32,0.625,13,45,0.289,37,42,0.881,116
1861,2020/2/11,HOU,BOS,W 116-105,240,33,77,0.429,20,32,0.625,13,45,0.289,37,42,0.881,116,37,85,0.435,26,53,0.491,11,32,0.344,20,25,0.8,105
1862,2020/2/11,NOP,POR,W 138-117,240,49,92,0.533,35,58,0.603,14,34,0.412,26,32,0.813,138,44,93,0.473,37,64,0.578,7,29,0.241,22,28,0.786,117
1863,2020/2/11,POR,NOP,L 117-138,240,44,93,0.473,37,64,0.578,7,29,0.241,22,28,0.786,117,49,92,0.533,35,58,0.603,14,34,0.412,26,32,0.813,138
1864,2020/2/11,OKC,SAS,L 106-114,240,39,85,0.459,28,54,0.519,11,31,0.355,17,21,0.81,106,41,84,0.488,34,59,0.576,7,25,0.28,25,27,0.926,114
1865,2020/2/11,SAS,OKC,W 114-106,240,41,84,0.488,34,59,0.576,7,25,0.28,25,27,0.926,114,39,85,0.459,28,54,0.519,11,31,0.355,17,21,0.81,106
1866,2020/2/11,LAC,PHI,L 103-110,240,40,90,0.444,26,59,0.441,14,31,0.452,9,13,0.692,103,44,95,0.463,36,68,0.529,8,27,0.296,14,21,0.667,110
1867,2020/2/11,PHI,LAC,W 110-103,240,44,95,0.463,36,68,0.529,8,27,0.296,14,21,0.667,110,40,90,0.444,26,59,0.441,14,31,0.452,9,13,0.692,103
1868,2020/2/11,CHI,WAS,L 114-126,240,44,92,0.478,28,53,0.528,16,39,0.41,10,14,0.714,114,48,89,0.539,37,57,0.649,11,32,0.344,19,24,0.792,126
1869,2020/2/11,WAS,CHI,W 126-114,240,48,89,0.539,37,57,0.649,11,32,0.344,19,24,0.792,126,44,92,0.478,28,53,0.528,16,39,0.41,10,14,0.714,114
1870,2020/2/10,DAL,UTA,L 119-123,240,39,83,0.47,24,40,0.6,15,43,0.349,26,31,0.839,119,46,78,0.59,31,43,0.721,15,35,0.429,16,21,0.762,123
1871,2020/2/10,UTA,DAL,W 123-119,240,46,78,0.59,31,43,0.721,15,35,0.429,16,21,0.762,123,39,83,0.47,24,40,0.6,15,43,0.349,26,31,0.839,119
1872,2020/2/10,DEN,SAS,W 127-120,240,45,80,0.563,27,45,0.6,18,35,0.514,19,23,0.826,127,41,85,0.482,25,53,0.472,16,32,0.5,22,25,0.88,120
1873,2020/2/10,SAS,DEN,L 120-127,240,41,85,0.482,25,53,0.472,16,32,0.5,22,25,0.88,120,45,80,0.563,27,45,0.6,18,35,0.514,19,23,0.826,127
1874,2020/2/10,CHO,DET,W 87-76,240,33,88,0.375,24,52,0.462,9,36,0.25,12,14,0.857,87,29,82,0.354,22,47,0.468,7,35,0.2,11,13,0.846,76
1875,2020/2/10,DET,CHO,L 76-87,240,29,82,0.354,22,47,0.468,7,35,0.2,11,13,0.846,76,33,88,0.375,24,52,0.462,9,36,0.25,12,14,0.857,87
1876,2020/2/10,GSW,MIA,L 101-113,240,30,77,0.39,19,43,0.442,11,34,0.324,30,34,0.882,101,43,87,0.494,31,54,0.574,12,33,0.364,15,21,0.714,113
1877,2020/2/10,MIA,GSW,W 113-101,240,43,87,0.494,31,54,0.574,12,33,0.364,15,21,0.714,113,30,77,0.39,19,43,0.442,11,34,0.324,30,34,0.882,101
1878,2020/2/10,BRK,IND,W 106-105,240,35,87,0.402,23,50,0.46,12,37,0.324,24,32,0.75,106,45,92,0.489,38,62,0.613,7,30,0.233,8,11,0.727,105
1879,2020/2/10,IND,BRK,L 105-106,240,45,92,0.489,38,62,0.613,7,30,0.233,8,11,0.727,105,35,87,0.402,23,50,0.46,12,37,0.324,24,32,0.75,106
1880,2020/2/10,LAL,PHO,W 125-100,240,47,91,0.516,33,54,0.611,14,37,0.378,17,25,0.68,125,32,76,0.421,21,45,0.467,11,31,0.355,25,31,0.806,100
1881,2020/2/10,PHO,LAL,L 100-125,240,32,76,0.421,21,45,0.467,11,31,0.355,25,31,0.806,100,47,91,0.516,33,54,0.611,14,37,0.378,17,25,0.68,125
1882,2020/2/10,MIL,SAC,W 123-111,240,43,96,0.448,25,54,0.463,18,42,0.429,19,23,0.826,123,42,101,0.416,28,58,0.483,14,43,0.326,13,18,0.722,111
1883,2020/2/10,SAC,MIL,L 111-123,240,42,101,0.416,28,58,0.483,14,43,0.326,13,18,0.722,111,43,96,0.448,25,54,0.463,18,42,0.429,19,23,0.826,123
1884,2020/2/10,ATL,ORL,L 126-135,240,47,88,0.534,31,51,0.608,16,37,0.432,16,17,0.941,126,50,95,0.526,32,57,0.561,18,38,0.474,17,22,0.773,135
1885,2020/2/10,ORL,ATL,W 135-126,240,50,95,0.526,32,57,0.561,18,38,0.474,17,22,0.773,135,47,88,0.534,31,51,0.608,16,37,0.432,16,17,0.941,126
1886,2020/2/10,MIN,TOR,L 126-137,240,39,86,0.453,21,46,0.457,18,40,0.45,30,35,0.857,126,51,89,0.573,34,56,0.607,17,33,0.515,18,23,0.783,137
1887,2020/2/10,TOR,MIN,W 137-126,240,51,89,0.573,34,56,0.607,17,33,0.515,18,23,0.783,137,39,86,0.453,21,46,0.457,18,40,0.45,30,35,0.857,126
1888,2020/2/9,ATL,NYK,W 140-135 (2OT),290,49,108,0.454,35,68,0.515,14,40,0.35,28,31,0.903,140,52,110,0.473,39,76,0.513,13,34,0.382,18,25,0.72,135
1889,2020/2/9,NYK,ATL,L 135-140 (2OT),290,52,110,0.473,39,76,0.513,13,34,0.382,18,25,0.72,135,49,108,0.454,35,68,0.515,14,40,0.35,28,31,0.903,140
1890,2020/2/9,CLE,LAC,L 92-133,240,35,95,0.368,28,62,0.452,7,33,0.212,15,22,0.682,92,53,93,0.57,41,57,0.719,12,36,0.333,15,20,0.75,133
1891,2020/2/9,LAC,CLE,W 133-92,240,53,93,0.57,41,57,0.719,12,36,0.333,15,20,0.75,133,35,95,0.368,28,62,0.452,7,33,0.212,15,22,0.682,92
1892,2020/2/9,HOU,UTA,L 113-114,240,44,95,0.463,29,53,0.547,15,42,0.357,10,14,0.714,113,42,86,0.488,27,48,0.563,15,38,0.395,15,18,0.833,114
1893,2020/2/9,UTA,HOU,W 114-113,240,42,86,0.488,27,48,0.563,15,38,0.395,15,18,0.833,114,44,95,0.463,29,53,0.547,15,42,0.357,10,14,0.714,113
1894,2020/2/9,BOS,OKC,W 112-111,240,38,84,0.452,22,48,0.458,16,36,0.444,20,27,0.741,112,39,86,0.453,28,59,0.475,11,27,0.407,22,29,0.759,111
1895,2020/2/9,OKC,BOS,L 111-112,240,39,86,0.453,28,59,0.475,11,27,0.407,22,29,0.759,111,38,84,0.452,22,48,0.458,16,36,0.444,20,27,0.741,112
1896,2020/2/9,CHI,PHI,L 111-118,240,43,88,0.489,31,56,0.554,12,32,0.375,13,17,0.765,111,42,84,0.5,31,57,0.544,11,27,0.407,23,32,0.719,118
1897,2020/2/9,PHI,CHI,W 118-111,240,42,84,0.5,31,57,0.544,11,27,0.407,23,32,0.719,118,43,88,0.489,31,56,0.554,12,32,0.375,13,17,0.765,111
1898,2020/2/9,MIA,POR,L 109-115,240,39,98,0.398,19,49,0.388,20,49,0.408,11,14,0.786,109,40,85,0.471,21,43,0.488,19,42,0.452,16,22,0.727,115
1899,2020/2/9,POR,MIA,W 115-109,240,40,85,0.471,21,43,0.488,19,42,0.452,16,22,0.727,115,39,98,0.398,19,49,0.388,20,49,0.408,11,14,0.786,109
1900,2020/2/9,MEM,WAS,W 106-99,240,43,102,0.422,38,70,0.543,5,32,0.156,15,25,0.6,106,35,100,0.35,28,67,0.418,7,33,0.212,22,29,0.759,99
1901,2020/2/9,WAS,MEM,L 99-106,240,35,100,0.35,28,67,0.418,7,33,0.212,22,29,0.759,99,43,102,0.422,38,70,0.543,5,32,0.156,15,25,0.6,106
1902,2020/2/8,CHO,DAL,L 100-116,240,38,87,0.437,27,51,0.529,11,36,0.306,13,18,0.722,100,44,87,0.506,27,52,0.519,17,35,0.486,11,11,1,116
1903,2020/2/8,DAL,CHO,W 116-100,240,44,87,0.506,27,52,0.519,17,35,0.486,11,11,1,116,38,87,0.437,27,51,0.529,11,36,0.306,13,18,0.722,100
1904,2020/2/8,DET,NYK,L 92-95,240,34,69,0.493,21,40,0.525,13,29,0.448,11,16,0.688,92,38,85,0.447,30,63,0.476,8,22,0.364,11,17,0.647,95
1905,2020/2/8,NYK,DET,W 95-92,240,38,85,0.447,30,63,0.476,8,22,0.364,11,17,0.647,95,34,69,0.493,21,40,0.525,13,29,0.448,11,16,0.688,92
1906,2020/2/8,GSW,LAL,L 120-125,240,46,89,0.517,33,57,0.579,13,32,0.406,15,23,0.652,120,43,82,0.524,29,53,0.547,14,29,0.483,25,34,0.735,125
1907,2020/2/8,LAL,GSW,W 125-120,240,43,82,0.524,29,53,0.547,14,29,0.483,25,34,0.735,125,46,89,0.517,33,57,0.579,13,32,0.406,15,23,0.652,120
1908,2020/2/8,IND,NOP,L 117-124,240,44,83,0.53,35,57,0.614,9,26,0.346,20,27,0.741,117,44,95,0.463,29,57,0.509,15,38,0.395,21,25,0.84,124
1909,2020/2/8,NOP,IND,W 124-117,240,44,95,0.463,29,57,0.509,15,38,0.395,21,25,0.84,124,44,83,0.53,35,57,0.614,9,26,0.346,20,27,0.741,117
1910,2020/2/8,LAC,MIN,L 115-142,240,41,86,0.477,32,60,0.533,9,26,0.346,24,29,0.828,115,52,95,0.547,26,51,0.51,26,44,0.591,12,18,0.667,142
1911,2020/2/8,MIN,LAC,W 142-115,240,52,95,0.547,26,51,0.51,26,44,0.591,12,18,0.667,142,41,86,0.477,32,60,0.533,9,26,0.346,24,29,0.828,115
1912,2020/2/8,MIL,ORL,W 111-95,240,42,93,0.452,27,54,0.5,15,39,0.385,12,16,0.75,111,37,98,0.378,27,58,0.466,10,40,0.25,11,14,0.786,95
1913,2020/2/8,ORL,MIL,L 95-111,240,37,98,0.378,27,58,0.466,10,40,0.25,11,14,0.786,95,42,93,0.452,27,54,0.5,15,39,0.385,12,16,0.75,111
1914,2020/2/8,DEN,PHO,W 117-108,240,45,82,0.549,34,54,0.63,11,28,0.393,16,21,0.762,117,38,87,0.437,29,55,0.527,9,32,0.281,23,23,1,108
1915,2020/2/8,PHO,DEN,L 108-117,240,38,87,0.437,29,55,0.527,9,32,0.281,23,23,1,108,45,82,0.549,34,54,0.63,11,28,0.393,16,21,0.762,117
1916,2020/2/8,SAC,SAS,W 122-102,240,45,86,0.523,26,51,0.51,19,35,0.543,13,20,0.65,122,41,81,0.506,34,57,0.596,7,24,0.292,13,18,0.722,102
1917,2020/2/8,SAS,SAC,L 102-122,240,41,81,0.506,34,57,0.596,7,24,0.292,13,18,0.722,102,45,86,0.523,26,51,0.51,19,35,0.543,13,20,0.65,122
1918,2020/2/8,BRK,TOR,L 118-119,240,41,92,0.446,25,48,0.521,16,44,0.364,20,24,0.833,118,45,95,0.474,31,60,0.517,14,35,0.4,15,21,0.714,119
1919,2020/2/8,TOR,BRK,W 119-118,240,45,95,0.474,31,60,0.517,14,35,0.4,15,21,0.714,119,41,92,0.446,25,48,0.521,16,44,0.364,20,24,0.833,118
1920,2020/2/7,ATL,BOS,L 107-112,240,35,86,0.407,22,47,0.468,13,39,0.333,24,26,0.923,107,37,86,0.43,21,49,0.429,16,37,0.432,22,27,0.815,112
1921,2020/2/7,BOS,ATL,W 112-107,240,37,86,0.43,21,49,0.429,16,37,0.432,22,27,0.815,112,35,86,0.407,22,47,0.468,13,39,0.333,24,26,0.923,107
1922,2020/2/7,IND,TOR,L 106-115,240,39,86,0.453,29,52,0.558,10,34,0.294,18,22,0.818,106,42,88,0.477,25,50,0.5,17,38,0.447,14,17,0.824,115
1923,2020/2/7,TOR,IND,W 115-106,240,42,88,0.477,25,50,0.5,17,38,0.447,14,17,0.824,115,39,86,0.453,29,52,0.558,10,34,0.294,18,22,0.818,106
1924,2020/2/7,DET,OKC,L 101-108,240,38,89,0.427,27,51,0.529,11,38,0.289,14,19,0.737,101,39,76,0.513,34,53,0.642,5,23,0.217,25,30,0.833,108
1925,2020/2/7,OKC,DET,W 108-101,240,39,76,0.513,34,53,0.642,5,23,0.217,25,30,0.833,108,38,89,0.427,27,51,0.529,11,38,0.289,14,19,0.737,101
1926,2020/2/7,MEM,PHI,L 107-119,240,38,93,0.409,33,72,0.458,5,21,0.238,26,31,0.839,107,48,90,0.533,34,65,0.523,14,25,0.56,9,15,0.6,119
1927,2020/2/7,PHI,MEM,W 119-107,240,48,90,0.533,34,65,0.523,14,25,0.56,9,15,0.6,119,38,93,0.409,33,72,0.458,5,21,0.238,26,31,0.839,107
1928,2020/2/7,HOU,PHO,L 91-127,240,29,85,0.341,18,37,0.486,11,48,0.229,22,26,0.846,91,43,77,0.558,28,46,0.609,15,31,0.484,26,27,0.963,127
1929,2020/2/7,PHO,HOU,W 127-91,240,43,77,0.558,28,46,0.609,15,31,0.484,26,27,0.963,127,29,85,0.341,18,37,0.486,11,48,0.229,22,26,0.846,91
1930,2020/2/7,MIA,SAC,L 97-105,240,34,77,0.442,22,37,0.595,12,40,0.3,17,25,0.68,97,40,82,0.488,21,38,0.553,19,44,0.432,6,12,0.5,105
1931,2020/2/7,SAC,MIA,W 105-97,240,40,82,0.488,21,38,0.553,19,44,0.432,6,12,0.5,105,34,77,0.442,22,37,0.595,12,40,0.3,17,25,0.68,97
1932,2020/2/7,POR,UTA,L 114-117,240,44,97,0.454,27,57,0.474,17,40,0.425,9,14,0.643,114,45,91,0.495,35,61,0.574,10,30,0.333,17,24,0.708,117
1933,2020/2/7,UTA,POR,W 117-114,240,45,91,0.495,35,61,0.574,10,30,0.333,17,24,0.708,117,44,97,0.454,27,57,0.474,17,40,0.425,9,14,0.643,114
1934,2020/2/7,DAL,WAS,L 118-119,240,42,91,0.462,26,51,0.51,16,40,0.4,18,21,0.857,118,45,90,0.5,26,52,0.5,19,38,0.5,10,13,0.769,119
1935,2020/2/7,WAS,DAL,W 119-118,240,45,90,0.5,26,52,0.5,19,38,0.5,10,13,0.769,119,42,91,0.462,26,51,0.51,16,40,0.4,18,21,0.857,118
1936,2020/2/6,CHI,NOP,L 119-125,240,46,93,0.495,33,64,0.516,13,29,0.448,14,23,0.609,119,49,87,0.563,33,49,0.673,16,38,0.421,11,19,0.579,125
1937,2020/2/6,NOP,CHI,W 125-119,240,49,87,0.563,33,49,0.673,16,38,0.421,11,19,0.579,125,46,93,0.495,33,64,0.516,13,29,0.448,14,23,0.609,119
1938,2020/2/6,HOU,LAL,W 121-111,240,43,85,0.506,24,43,0.558,19,42,0.452,16,18,0.889,121,45,91,0.495,36,60,0.6,9,31,0.29,12,16,0.75,111
1939,2020/2/6,LAL,HOU,L 111-121,240,45,91,0.495,36,60,0.6,9,31,0.29,12,16,0.75,111,43,85,0.506,24,43,0.558,19,42,0.452,16,18,0.889,121
1940,2020/2/6,MIL,PHI,W 112-101,240,44,94,0.468,32,57,0.561,12,37,0.324,12,18,0.667,112,37,99,0.374,18,54,0.333,19,45,0.422,8,14,0.571,101
1941,2020/2/6,PHI,MIL,L 101-112,240,37,99,0.374,18,54,0.333,19,45,0.422,8,14,0.571,101,44,94,0.468,32,57,0.561,12,37,0.324,12,18,0.667,112
1942,2020/2/6,NYK,ORL,W 105-103,240,43,92,0.467,37,72,0.514,6,20,0.3,13,19,0.684,105,34,75,0.453,25,44,0.568,9,31,0.29,26,30,0.867,103
1943,2020/2/6,ORL,NYK,L 103-105,240,34,75,0.453,25,44,0.568,9,31,0.29,26,30,0.867,103,43,92,0.467,37,72,0.514,6,20,0.3,13,19,0.684,105
1944,2020/2/6,POR,SAS,W 125-117,240,49,92,0.533,31,55,0.564,18,37,0.486,9,12,0.75,125,41,92,0.446,31,64,0.484,10,28,0.357,25,28,0.893,117
1945,2020/2/6,SAS,POR,L 117-125,240,41,92,0.446,31,64,0.484,10,28,0.357,25,28,0.893,117,49,92,0.533,31,55,0.564,18,37,0.486,9,12,0.75,125
1946,2020/2/5,BOS,ORL,W 116-100,240,46,86,0.535,33,63,0.524,13,23,0.565,11,16,0.688,116,32,75,0.427,19,44,0.432,13,31,0.419,23,30,0.767,100
1947,2020/2/5,ORL,BOS,L 100-116,240,32,75,0.427,19,44,0.432,13,31,0.419,23,30,0.767,100,46,86,0.535,33,63,0.524,13,23,0.565,11,16,0.688,116
1948,2020/2/5,BRK,GSW,W 129-88,240,51,100,0.51,37,66,0.561,14,34,0.412,13,15,0.867,129,35,96,0.365,30,57,0.526,5,39,0.128,13,18,0.722,88
1949,2020/2/5,GSW,BRK,L 88-129,240,35,96,0.365,30,57,0.526,5,39,0.128,13,18,0.722,88,51,100,0.51,37,66,0.561,14,34,0.412,13,15,0.867,129
1950,2020/2/5,DAL,MEM,L 107-121,240,34,94,0.362,17,51,0.333,17,43,0.395,22,24,0.917,107,47,89,0.528,35,64,0.547,12,25,0.48,15,20,0.75,121
1951,2020/2/5,MEM,DAL,W 121-107,240,47,89,0.528,35,64,0.547,12,25,0.48,15,20,0.75,121,34,94,0.362,17,51,0.333,17,43,0.395,22,24,0.917,107
1952,2020/2/5,DET,PHO,W 116-108,240,46,95,0.484,34,67,0.507,12,28,0.429,12,16,0.75,116,42,77,0.545,30,51,0.588,12,26,0.462,12,15,0.8,108
1953,2020/2/5,PHO,DET,L 108-116,240,42,77,0.545,30,51,0.588,12,26,0.462,12,15,0.8,108,46,95,0.484,34,67,0.507,12,28,0.429,12,16,0.75,116
1954,2020/2/5,LAC,MIA,W 128-111,240,45,89,0.506,21,35,0.6,24,54,0.444,14,19,0.737,128,40,93,0.43,24,51,0.471,16,42,0.381,15,21,0.714,111
1955,2020/2/5,MIA,LAC,L 111-128,240,40,93,0.43,24,51,0.471,16,42,0.381,15,21,0.714,111,45,89,0.506,21,35,0.6,24,54,0.444,14,19,0.737,128
1956,2020/2/5,ATL,MIN,W 127-120,240,43,82,0.524,30,50,0.6,13,32,0.406,28,30,0.933,127,45,91,0.495,36,56,0.643,9,35,0.257,21,28,0.75,120
1957,2020/2/5,MIN,ATL,L 120-127,240,45,91,0.495,36,56,0.643,9,35,0.257,21,28,0.75,120,43,82,0.524,30,50,0.6,13,32,0.406,28,30,0.933,127
1958,2020/2/5,CLE,OKC,L 103-109,240,41,89,0.461,26,51,0.51,15,38,0.395,6,11,0.545,103,38,81,0.469,29,55,0.527,9,26,0.346,24,30,0.8,109
1959,2020/2/5,OKC,CLE,W 109-103,240,38,81,0.469,29,55,0.527,9,26,0.346,24,30,0.8,109,41,89,0.461,26,51,0.51,15,38,0.395,6,11,0.545,103
1960,2020/2/5,IND,TOR,L 118-119,240,43,82,0.524,24,43,0.558,19,39,0.487,13,16,0.813,118,43,86,0.5,31,54,0.574,12,32,0.375,21,24,0.875,119
1961,2020/2/5,TOR,IND,W 119-118,240,43,86,0.5,31,54,0.574,12,32,0.375,21,24,0.875,119,43,82,0.524,24,43,0.558,19,39,0.487,13,16,0.813,118
1962,2020/2/5,DEN,UTA,W 98-95,240,39,90,0.433,32,60,0.533,7,30,0.233,13,18,0.722,98,36,86,0.419,22,47,0.468,14,39,0.359,9,14,0.643,95
1963,2020/2/5,UTA,DEN,L 95-98,240,36,86,0.419,22,47,0.468,14,39,0.359,9,14,0.643,95,39,90,0.433,32,60,0.533,7,30,0.233,13,18,0.722,98
1964,2020/2/4,DEN,POR,W 127-99,240,46,90,0.511,29,56,0.518,17,34,0.5,18,25,0.72,127,36,91,0.396,27,60,0.45,9,31,0.29,18,22,0.818,99
1965,2020/2/4,POR,DEN,L 99-127,240,36,91,0.396,27,60,0.45,9,31,0.29,18,22,0.818,99,46,90,0.511,29,56,0.518,17,34,0.5,18,25,0.72,127
1966,2020/2/4,CHO,HOU,L 110-125,240,39,83,0.47,26,50,0.52,13,33,0.394,19,24,0.792,110,43,97,0.443,23,37,0.622,20,60,0.333,19,23,0.826,125
1967,2020/2/4,HOU,CHO,W 125-110,240,43,97,0.443,23,37,0.622,20,60,0.333,19,23,0.826,125,39,83,0.47,26,50,0.52,13,33,0.394,19,24,0.792,110
1968,2020/2/4,LAL,SAS,W 129-102,240,50,85,0.588,38,57,0.667,12,28,0.429,17,25,0.68,129,40,91,0.44,27,64,0.422,13,27,0.481,9,15,0.6,102
1969,2020/2/4,SAS,LAL,L 102-129,240,40,91,0.44,27,64,0.422,13,27,0.481,9,15,0.6,102,50,85,0.588,38,57,0.667,12,28,0.429,17,25,0.68,129
1970,2020/2/4,MIL,NOP,W 120-108,240,48,102,0.471,37,66,0.561,11,36,0.306,13,17,0.765,120,38,99,0.384,24,50,0.48,14,49,0.286,18,24,0.75,108
1971,2020/2/4,NOP,MIL,L 108-120,240,38,99,0.384,24,50,0.48,14,49,0.286,18,24,0.75,108,48,102,0.471,37,66,0.561,11,36,0.306,13,17,0.765,120
1972,2020/2/3,ATL,BOS,L 115-123,240,42,84,0.5,30,54,0.556,12,30,0.4,19,21,0.905,115,48,90,0.533,36,61,0.59,12,29,0.414,15,17,0.882,123
1973,2020/2/3,BOS,ATL,W 123-115,240,48,90,0.533,36,61,0.59,12,29,0.414,15,17,0.882,123,42,84,0.5,30,54,0.556,12,30,0.4,19,21,0.905,115
1974,2020/2/3,BRK,PHO,W 119-97,240,43,89,0.483,28,55,0.509,15,34,0.441,18,21,0.857,119,39,90,0.433,33,73,0.452,6,17,0.353,13,18,0.722,97
1975,2020/2/3,PHO,BRK,L 97-119,240,39,90,0.433,33,73,0.452,6,17,0.353,13,18,0.722,97,43,89,0.483,28,55,0.509,15,34,0.441,18,21,0.857,119
1976,2020/2/3,CHO,ORL,L 100-112,240,41,89,0.461,32,58,0.552,9,31,0.29,9,14,0.643,100,43,80,0.538,27,46,0.587,16,34,0.471,10,17,0.588,112
1977,2020/2/3,ORL,CHO,W 112-100,240,43,80,0.538,27,46,0.587,16,34,0.471,10,17,0.588,112,41,89,0.461,32,58,0.552,9,31,0.29,9,14,0.643,100
1978,2020/2/3,CLE,NYK,L 134-139 (OT),265,52,92,0.565,34,57,0.596,18,35,0.514,12,18,0.667,134,57,102,0.559,47,76,0.618,10,26,0.385,15,21,0.714,139
1979,2020/2/3,NYK,CLE,W 139-134 (OT),265,57,102,0.559,47,76,0.618,10,26,0.385,15,21,0.714,139,52,92,0.565,34,57,0.596,18,35,0.514,12,18,0.667,134
1980,2020/2/3,DAL,IND,W 112-103,240,36,86,0.419,18,41,0.439,18,45,0.4,22,23,0.957,112,44,96,0.458,37,62,0.597,7,34,0.206,8,11,0.727,103
1981,2020/2/3,IND,DAL,L 103-112,240,44,96,0.458,37,62,0.597,7,34,0.206,8,11,0.727,103,36,86,0.419,18,41,0.439,18,45,0.4,22,23,0.957,112
1982,2020/2/3,LAC,SAS,W 108-105,240,39,84,0.464,28,57,0.491,11,27,0.407,19,24,0.792,108,40,95,0.421,28,58,0.483,12,37,0.324,13,16,0.813,105
1983,2020/2/3,SAS,LAC,L 105-108,240,40,95,0.421,28,58,0.483,12,37,0.324,13,16,0.813,105,39,84,0.464,28,57,0.491,11,27,0.407,19,24,0.792,108
1984,2020/2/3,DET,MEM,L 82-96,240,34,98,0.347,26,72,0.361,8,26,0.308,6,9,0.667,82,42,90,0.467,40,73,0.548,2,17,0.118,10,12,0.833,96
1985,2020/2/3,MEM,DET,W 96-82,240,42,90,0.467,40,73,0.548,2,17,0.118,10,12,0.833,96,34,98,0.347,26,72,0.361,8,26,0.308,6,9,0.667,82
1986,2020/2/3,MIA,PHI,W 137-106,240,48,85,0.565,32,53,0.604,16,32,0.5,25,30,0.833,137,36,83,0.434,23,45,0.511,13,38,0.342,21,25,0.84,106
1987,2020/2/3,PHI,MIA,L 106-137,240,36,83,0.434,23,45,0.511,13,38,0.342,21,25,0.84,106,48,85,0.565,32,53,0.604,16,32,0.5,25,30,0.833,137
1988,2020/2/3,MIN,SAC,L 109-113,240,37,85,0.435,24,47,0.511,13,38,0.342,22,28,0.786,109,38,75,0.507,24,48,0.5,14,27,0.519,23,31,0.742,113
1989,2020/2/3,SAC,MIN,W 113-109,240,38,75,0.507,24,48,0.5,14,27,0.519,23,31,0.742,113,37,85,0.435,24,47,0.511,13,38,0.342,22,28,0.786,109
1990,2020/2/3,GSW,WAS,W 125-117,240,43,87,0.494,28,57,0.491,15,30,0.5,24,31,0.774,125,42,83,0.506,33,61,0.541,9,22,0.409,24,29,0.828,117
1991,2020/2/3,WAS,GSW,L 117-125,240,42,83,0.506,33,61,0.541,9,22,0.409,24,29,0.828,117,43,87,0.494,28,57,0.491,15,30,0.5,24,31,0.774,125
1992,2020/2/2,DEN,DET,L 123-128 (OT),265,48,96,0.5,38,64,0.594,10,32,0.313,17,22,0.773,123,48,94,0.511,34,63,0.54,14,31,0.452,18,24,0.75,128
1993,2020/2/2,DET,DEN,W 128-123 (OT),265,48,94,0.511,34,63,0.54,14,31,0.452,18,24,0.75,128,48,96,0.5,38,64,0.594,10,32,0.313,17,22,0.773,123
1994,2020/2/2,HOU,NOP,W 117-109,240,41,105,0.39,25,54,0.463,16,51,0.314,19,22,0.864,117,42,94,0.447,32,61,0.525,10,33,0.303,15,20,0.75,109
1995,2020/2/2,NOP,HOU,L 109-117,240,42,94,0.447,32,61,0.525,10,33,0.303,15,20,0.75,109,41,105,0.39,25,54,0.463,16,51,0.314,19,22,0.864,117
1996,2020/2/2,MIL,PHO,W 129-108,240,48,97,0.495,33,59,0.559,15,38,0.395,18,27,0.667,129,41,104,0.394,35,81,0.432,6,23,0.261,20,23,0.87,108
1997,2020/2/2,PHO,MIL,L 108-129,240,41,104,0.394,35,81,0.432,6,23,0.261,20,23,0.87,108,48,97,0.495,33,59,0.559,15,38,0.395,18,27,0.667,129
1998,2020/2/2,CHI,TOR,L 102-129,240,35,90,0.389,20,42,0.476,15,48,0.313,17,26,0.654,102,47,84,0.56,31,50,0.62,16,34,0.471,19,23,0.826,129
1999,2020/2/2,TOR,CHI,W 129-102,240,47,84,0.56,31,50,0.62,16,34,0.471,19,23,0.826,129,35,90,0.389,20,42,0.476,15,48,0.313,17,26,0.654,102
2000,2020/2/1,BOS,PHI,W 116-95,240,38,80,0.475,30,50,0.6,8,30,0.267,32,41,0.78,116,31,84,0.369,24,51,0.471,7,33,0.212,26,31,0.839,95
2001,2020/2/1,PHI,BOS,L 95-116,240,31,84,0.369,24,51,0.471,7,33,0.212,26,31,0.839,95,38,80,0.475,30,50,0.6,8,30,0.267,32,41,0.78,116
2002,2020/2/1,CLE,GSW,L 112-131,240,41,95,0.432,25,51,0.49,16,44,0.364,14,14,1,112,48,90,0.533,30,55,0.545,18,35,0.514,17,19,0.895,131
2003,2020/2/1,GSW,CLE,W 131-112,240,48,90,0.533,30,55,0.545,18,35,0.514,17,19,0.895,131,41,95,0.432,25,51,0.49,16,44,0.364,14,14,1,112
2004,2020/2/1,ATL,DAL,L 100-123,240,37,91,0.407,27,58,0.466,10,33,0.303,16,21,0.762,100,44,94,0.468,24,55,0.436,20,39,0.513,15,16,0.938,123
2005,2020/2/1,DAL,ATL,W 123-100,240,44,94,0.468,24,55,0.436,20,39,0.513,15,16,0.938,123,37,91,0.407,27,58,0.466,10,33,0.303,16,21,0.762,100
2006,2020/2/1,IND,NYK,L 85-92,240,32,76,0.421,24,52,0.462,8,24,0.333,13,21,0.619,85,34,82,0.415,27,56,0.482,7,26,0.269,17,23,0.739,92
2007,2020/2/1,NYK,IND,W 92-85,240,34,82,0.415,27,56,0.482,7,26,0.269,17,23,0.739,92,32,76,0.421,24,52,0.462,8,24,0.333,13,21,0.619,85
2008,2020/2/1,LAC,MIN,W 118-106,240,45,98,0.459,33,64,0.516,12,34,0.353,16,18,0.889,118,34,84,0.405,27,45,0.6,7,39,0.179,31,37,0.838,106
2009,2020/2/1,MIN,LAC,L 106-118,240,34,84,0.405,27,45,0.6,7,39,0.179,31,37,0.838,106,45,98,0.459,33,64,0.516,12,34,0.353,16,18,0.889,118
2010,2020/2/1,MIA,ORL,W 102-89,240,33,77,0.429,18,44,0.409,15,33,0.455,21,26,0.808,102,33,83,0.398,24,50,0.48,9,33,0.273,14,17,0.824,89
2011,2020/2/1,ORL,MIA,L 89-102,240,33,83,0.398,24,50,0.48,9,33,0.273,14,17,0.824,89,33,77,0.429,18,44,0.409,15,33,0.455,21,26,0.808,102
2012,2020/2/1,POR,UTA,W 124-107,240,47,92,0.511,32,63,0.508,15,29,0.517,15,18,0.833,124,40,94,0.426,22,53,0.415,18,41,0.439,9,9,1,107
2013,2020/2/1,UTA,POR,L 107-124,240,40,94,0.426,22,53,0.415,18,41,0.439,9,9,1,107,47,92,0.511,32,63,0.508,15,29,0.517,15,18,0.833,124
2014,2020/2/1,LAL,SAC,W 129-113,240,44,86,0.512,25,43,0.581,19,43,0.442,22,27,0.815,129,39,91,0.429,25,47,0.532,14,44,0.318,21,26,0.808,113
2015,2020/2/1,SAC,LAL,L 113-129,240,39,91,0.429,25,47,0.532,14,44,0.318,21,26,0.808,113,44,86,0.512,25,43,0.581,19,43,0.442,22,27,0.815,129
2016,2020/2/1,CHO,SAS,L 90-114,240,35,83,0.422,25,47,0.532,10,36,0.278,10,12,0.833,90,45,87,0.517,35,59,0.593,10,28,0.357,14,21,0.667,114
2017,2020/2/1,SAS,CHO,W 114-90,240,45,87,0.517,35,59,0.593,10,28,0.357,14,21,0.667,114,35,83,0.422,25,47,0.532,10,36,0.278,10,12,0.833,90
2018,2020/2/1,BRK,WAS,L 107-113,240,39,94,0.415,23,47,0.489,16,47,0.34,13,21,0.619,107,44,100,0.44,35,68,0.515,9,32,0.281,16,26,0.615,113
2019,2020/2/1,WAS,BRK,W 113-107,240,44,100,0.44,35,68,0.515,9,32,0.281,16,26,0.615,113,39,94,0.415,23,47,0.489,16,47,0.34,13,21,0.619,107
2020,2020/1/31,BRK,CHI,W 133-118,240,50,80,0.625,35,49,0.714,15,31,0.484,18,25,0.72,133,42,86,0.488,30,52,0.577,12,34,0.353,22,26,0.846,118
2021,2020/1/31,CHI,BRK,L 118-133,240,42,86,0.488,30,52,0.577,12,34,0.353,22,26,0.846,118,50,80,0.625,35,49,0.714,15,31,0.484,18,25,0.72,133
2022,2020/1/31,DET,TOR,L 92-105,240,28,79,0.354,17,43,0.395,11,36,0.306,25,34,0.735,92,44,85,0.518,35,58,0.603,9,27,0.333,8,11,0.727,105
2023,2020/1/31,TOR,DET,W 105-92,240,44,85,0.518,35,58,0.603,9,27,0.333,8,11,0.727,105,28,79,0.354,17,43,0.395,11,36,0.306,25,34,0.735,92
2024,2020/1/31,DAL,HOU,L 121-128,240,43,90,0.478,29,54,0.537,14,36,0.389,21,27,0.778,121,45,98,0.459,24,53,0.453,21,45,0.467,17,20,0.85,128
2025,2020/1/31,HOU,DAL,W 128-121,240,45,98,0.459,24,53,0.453,21,45,0.467,17,20,0.85,128,43,90,0.478,29,54,0.537,14,36,0.389,21,27,0.778,121
2026,2020/1/31,LAL,POR,L 119-127,240,45,96,0.469,34,64,0.531,11,32,0.344,18,28,0.643,119,49,97,0.505,36,61,0.59,13,36,0.361,16,21,0.762,127
2027,2020/1/31,POR,LAL,W 127-119,240,49,97,0.505,36,61,0.59,13,36,0.361,16,21,0.762,127,45,96,0.469,34,64,0.531,11,32,0.344,18,28,0.643,119
2028,2020/1/31,DEN,MIL,W 127-115,240,48,100,0.48,26,54,0.481,22,46,0.478,9,9,1,127,43,95,0.453,31,55,0.564,12,40,0.3,17,26,0.654,115
2029,2020/1/31,MIL,DEN,L 115-127,240,43,95,0.453,31,55,0.564,12,40,0.3,17,26,0.654,115,48,100,0.48,26,54,0.481,22,46,0.478,9,9,1,127
2030,2020/1/31,MEM,NOP,L 111-139,240,45,96,0.469,39,65,0.6,6,31,0.194,15,26,0.577,111,51,95,0.537,36,61,0.59,15,34,0.441,22,26,0.846,139
2031,2020/1/31,NOP,MEM,W 139-111,240,51,95,0.537,36,61,0.59,15,34,0.441,22,26,0.846,139,45,96,0.469,39,65,0.6,6,31,0.194,15,26,0.577,111
2032,2020/1/31,OKC,PHO,W 111-107,240,42,97,0.433,35,66,0.53,7,31,0.226,20,22,0.909,111,36,76,0.474,27,52,0.519,9,24,0.375,26,29,0.897,107
2033,2020/1/31,PHO,OKC,L 107-111,240,36,76,0.474,27,52,0.519,9,24,0.375,26,29,0.897,107,42,97,0.433,35,66,0.53,7,31,0.226,20,22,0.909,111
2034,2020/1/30,ATL,PHI,W 127-117,240,42,87,0.483,31,52,0.596,11,35,0.314,32,37,0.865,127,38,82,0.463,29,51,0.569,9,31,0.29,32,45,0.711,117
2035,2020/1/30,PHI,ATL,L 117-127,240,38,82,0.463,29,51,0.569,9,31,0.29,32,45,0.711,117,42,87,0.483,31,52,0.596,11,35,0.314,32,37,0.865,127
2036,2020/1/30,BOS,GSW,W 119-104,240,42,88,0.477,27,53,0.509,15,35,0.429,20,22,0.909,119,33,77,0.429,21,38,0.553,12,39,0.308,26,30,0.867,104
2037,2020/1/30,GSW,BOS,L 104-119,240,33,77,0.429,21,38,0.553,12,39,0.308,26,30,0.867,104,42,88,0.477,27,53,0.509,15,35,0.429,20,22,0.909,119
2038,2020/1/30,CLE,TOR,L 109-115,240,42,90,0.467,29,54,0.537,13,36,0.361,12,14,0.857,109,41,84,0.488,29,52,0.558,12,32,0.375,21,28,0.75,115
2039,2020/1/30,TOR,CLE,W 115-109,240,41,84,0.488,29,52,0.558,12,32,0.375,21,28,0.75,115,42,90,0.467,29,54,0.537,13,36,0.361,12,14,0.857,109
2040,2020/1/30,DEN,UTA,W 106-100,240,40,85,0.471,31,58,0.534,9,27,0.333,17,21,0.81,106,36,78,0.462,19,41,0.463,17,37,0.459,11,17,0.647,100
2041,2020/1/30,UTA,DEN,L 100-106,240,36,78,0.462,19,41,0.463,17,37,0.459,11,17,0.647,100,40,85,0.471,31,58,0.534,9,27,0.333,17,21,0.81,106
2042,2020/1/30,LAC,SAC,L 103-124,240,35,92,0.38,22,61,0.361,13,31,0.419,20,25,0.8,103,44,88,0.5,23,47,0.489,21,41,0.512,15,18,0.833,124
2043,2020/1/30,SAC,LAC,W 124-103,240,44,88,0.5,23,47,0.489,21,41,0.512,15,18,0.833,124,35,92,0.38,22,61,0.361,13,31,0.419,20,25,0.8,103
2044,2020/1/30,CHO,WAS,L 107-121,240,43,99,0.434,34,69,0.493,9,30,0.3,12,19,0.632,107,41,86,0.477,27,49,0.551,14,37,0.378,25,27,0.926,121
2045,2020/1/30,WAS,CHO,W 121-107,240,41,86,0.477,27,49,0.551,14,37,0.378,25,27,0.926,121,43,99,0.434,34,69,0.493,9,30,0.3,12,19,0.632,107
2046,2020/1/29,BRK,DET,W 125-115,240,43,85,0.506,28,46,0.609,15,39,0.385,24,30,0.8,125,42,83,0.506,32,57,0.561,10,26,0.385,21,28,0.75,115
2047,2020/1/29,DET,BRK,L 115-125,240,42,83,0.506,32,57,0.561,10,26,0.385,21,28,0.75,115,43,85,0.506,28,46,0.609,15,39,0.385,24,30,0.8,125
2048,2020/1/29,CHI,IND,L 106-115 (OT),265,45,85,0.529,39,52,0.75,6,33,0.182,10,15,0.667,106,46,89,0.517,39,62,0.629,7,27,0.259,16,22,0.727,115
2049,2020/1/29,IND,CHI,W 115-106 (OT),265,46,89,0.517,39,62,0.629,7,27,0.259,16,22,0.727,115,45,85,0.529,39,52,0.75,6,33,0.182,10,15,0.667,106
2050,2020/1/29,MEM,NYK,W 127-106,240,43,86,0.5,30,58,0.517,13,28,0.464,28,33,0.848,127,39,91,0.429,30,63,0.476,9,28,0.321,19,29,0.655,106
2051,2020/1/29,NYK,MEM,L 106-127,240,39,91,0.429,30,63,0.476,9,28,0.321,19,29,0.655,106,43,86,0.5,30,58,0.517,13,28,0.464,28,33,0.848,127
2052,2020/1/29,HOU,POR,L 112-125,240,40,94,0.426,23,47,0.489,17,47,0.362,15,18,0.833,112,46,89,0.517,33,53,0.623,13,36,0.361,20,27,0.741,125
2053,2020/1/29,POR,HOU,W 125-112,240,46,89,0.517,33,53,0.623,13,36,0.361,20,27,0.741,125,40,94,0.426,23,47,0.489,17,47,0.362,15,18,0.833,112
2054,2020/1/29,OKC,SAC,W 120-100,240,44,88,0.5,29,54,0.537,15,34,0.441,17,20,0.85,120,42,91,0.462,33,52,0.635,9,39,0.231,7,11,0.636,100
2055,2020/1/29,SAC,OKC,L 100-120,240,42,91,0.462,33,52,0.635,9,39,0.231,7,11,0.636,100,44,88,0.5,29,54,0.537,15,34,0.441,17,20,0.85,120
2056,2020/1/29,SAS,UTA,W 127-120,240,46,82,0.561,38,51,0.745,8,31,0.258,27,30,0.9,127,37,84,0.44,23,46,0.5,14,38,0.368,32,46,0.696,120
2057,2020/1/29,UTA,SAS,L 120-127,240,37,84,0.44,23,46,0.5,14,38,0.368,32,46,0.696,120,46,82,0.561,38,51,0.745,8,31,0.258,27,30,0.9,127
2058,2020/1/28,CHO,NYK,W 97-92,240,34,88,0.386,26,56,0.464,8,32,0.25,21,27,0.778,97,38,86,0.442,29,54,0.537,9,32,0.281,7,11,0.636,92
2059,2020/1/28,NYK,CHO,L 92-97,240,38,86,0.442,29,54,0.537,9,32,0.281,7,11,0.636,92,34,88,0.386,26,56,0.464,8,32,0.25,21,27,0.778,97
2060,2020/1/28,CLE,NOP,L 111-125,240,42,97,0.433,31,63,0.492,11,34,0.324,16,18,0.889,111,47,88,0.534,34,54,0.63,13,34,0.382,18,24,0.75,125
2061,2020/1/28,NOP,CLE,W 125-111,240,47,88,0.534,34,54,0.63,13,34,0.382,18,24,0.75,125,42,97,0.433,31,63,0.492,11,34,0.324,16,18,0.889,111
2062,2020/1/28,DAL,PHO,L 104-133,240,37,83,0.446,30,50,0.6,7,33,0.212,23,27,0.852,104,51,86,0.593,39,58,0.672,12,28,0.429,19,21,0.905,133
2063,2020/1/28,PHO,DAL,W 133-104,240,51,86,0.593,39,58,0.672,12,28,0.429,19,21,0.905,133,37,83,0.446,30,50,0.6,7,33,0.212,23,27,0.852,104
2064,2020/1/28,DEN,MEM,L 96-104,240,32,86,0.372,15,41,0.366,17,45,0.378,15,18,0.833,96,46,82,0.561,40,64,0.625,6,18,0.333,6,14,0.429,104
2065,2020/1/28,MEM,DEN,W 104-96,240,46,82,0.561,40,64,0.625,6,18,0.333,6,14,0.429,104,32,86,0.372,15,41,0.366,17,45,0.378,15,18,0.833,96
2066,2020/1/28,BOS,MIA,W 109-101,240,39,83,0.47,26,47,0.553,13,36,0.361,18,24,0.75,109,33,89,0.371,24,52,0.462,9,37,0.243,26,31,0.839,101
2067,2020/1/28,MIA,BOS,L 101-109,240,33,89,0.371,24,52,0.462,9,37,0.243,26,31,0.839,101,39,83,0.47,26,47,0.553,13,36,0.361,18,24,0.75,109
2068,2020/1/28,MIL,WAS,W 151-131,240,50,90,0.556,31,53,0.585,19,37,0.514,32,35,0.914,151,44,94,0.468,30,62,0.484,14,32,0.438,29,34,0.853,131
2069,2020/1/28,WAS,MIL,L 131-151,240,44,94,0.468,30,62,0.484,14,32,0.438,29,34,0.853,131,50,90,0.556,31,53,0.585,19,37,0.514,32,35,0.914,151
2070,2020/1/28,GSW,PHI,L 104-115,240,37,87,0.425,22,47,0.468,15,40,0.375,15,21,0.714,104,42,82,0.512,31,50,0.62,11,32,0.344,20,26,0.769,115
2071,2020/1/28,PHI,GSW,W 115-104,240,42,82,0.512,31,50,0.62,11,32,0.344,20,26,0.769,115,37,87,0.425,22,47,0.468,15,40,0.375,15,21,0.714,104
2072,2020/1/28,ATL,TOR,L 114-130,240,41,92,0.446,29,45,0.644,12,47,0.255,20,25,0.8,114,48,97,0.495,35,54,0.648,13,43,0.302,21,27,0.778,130
2073,2020/1/28,TOR,ATL,W 130-114,240,48,97,0.495,35,54,0.648,13,43,0.302,21,27,0.778,130,41,92,0.446,29,45,0.644,12,47,0.255,20,25,0.8,114
2074,2020/1/27,CHI,SAS,W 110-109,240,42,93,0.452,28,56,0.5,14,37,0.378,12,15,0.8,110,38,82,0.463,28,57,0.491,10,25,0.4,23,34,0.676,109
2075,2020/1/27,SAS,CHI,L 109-110,240,38,82,0.463,28,57,0.491,10,25,0.4,23,34,0.676,109,42,93,0.452,28,56,0.5,14,37,0.378,12,15,0.8,110
2076,2020/1/27,CLE,DET,W 115-100,240,48,96,0.5,39,72,0.542,9,24,0.375,10,13,0.769,115,38,84,0.452,26,49,0.531,12,35,0.343,12,17,0.706,100
2077,2020/1/27,DET,CLE,L 100-115,240,38,84,0.452,26,49,0.531,12,35,0.343,12,17,0.706,100,48,96,0.5,39,72,0.542,9,24,0.375,10,13,0.769,115
2078,2020/1/27,MIA,ORL,W 113-92,240,42,79,0.532,28,51,0.549,14,28,0.5,15,16,0.938,113,33,89,0.371,22,52,0.423,11,37,0.297,15,19,0.789,92
2079,2020/1/27,ORL,MIA,L 92-113,240,33,89,0.371,22,52,0.423,11,37,0.297,15,19,0.789,92,42,79,0.532,28,51,0.549,14,28,0.5,15,16,0.938,113
2080,2020/1/27,MIN,SAC,L 129-133 (OT),265,43,89,0.483,20,43,0.465,23,46,0.5,20,33,0.606,129,44,88,0.5,26,48,0.542,18,40,0.45,27,34,0.794,133
2081,2020/1/27,SAC,MIN,W 133-129 (OT),265,44,88,0.5,26,48,0.542,18,40,0.45,27,34,0.794,133,43,89,0.483,20,43,0.465,23,46,0.5,20,33,0.606,129
2082,2020/1/27,DAL,OKC,W 107-97,240,41,99,0.414,22,48,0.458,19,51,0.373,6,9,0.667,107,34,86,0.395,22,56,0.393,12,30,0.4,17,19,0.895,97
2083,2020/1/27,OKC,DAL,L 97-107,240,34,86,0.395,22,56,0.393,12,30,0.4,17,19,0.895,97,41,99,0.414,22,48,0.458,19,51,0.373,6,9,0.667,107
2084,2020/1/27,HOU,UTA,W 126-117,240,38,81,0.469,23,41,0.561,15,40,0.375,35,49,0.714,126,43,85,0.506,31,43,0.721,12,42,0.286,19,26,0.731,117
2085,2020/1/27,UTA,HOU,L 117-126,240,43,85,0.506,31,43,0.721,12,42,0.286,19,26,0.731,117,38,81,0.469,23,41,0.561,15,40,0.375,35,49,0.714,126
2086,2020/1/26,ATL,WAS,W 152-133,240,54,93,0.581,39,58,0.672,15,35,0.429,29,34,0.853,152,42,88,0.477,31,55,0.564,11,33,0.333,38,42,0.905,133
2087,2020/1/26,WAS,ATL,L 133-152,240,42,88,0.477,31,55,0.564,11,33,0.333,38,42,0.905,133,54,93,0.581,39,58,0.672,15,35,0.429,29,34,0.853,152
2088,2020/1/26,DEN,HOU,W 117-110,240,44,93,0.473,33,65,0.508,11,28,0.393,18,20,0.9,117,40,88,0.455,29,55,0.527,11,33,0.333,19,27,0.704,110
2089,2020/1/26,HOU,DEN,L 110-117,240,40,88,0.455,29,55,0.527,11,33,0.333,19,27,0.704,110,44,93,0.473,33,65,0.508,11,28,0.393,18,20,0.9,117
2090,2020/1/26,MEM,PHO,W 114-109,240,44,84,0.524,36,65,0.554,8,19,0.421,18,26,0.692,114,35,92,0.38,24,63,0.381,11,29,0.379,28,35,0.8,109
2091,2020/1/26,PHO,MEM,L 109-114,240,35,92,0.38,24,63,0.381,11,29,0.379,28,35,0.8,109,44,84,0.524,36,65,0.554,8,19,0.421,18,26,0.692,114
2092,2020/1/26,BOS,NOP,L 108-123,240,41,89,0.461,33,56,0.589,8,33,0.242,18,22,0.818,108,44,92,0.478,28,56,0.5,16,36,0.444,19,29,0.655,123
2093,2020/1/26,NOP,BOS,W 123-108,240,44,92,0.478,28,56,0.5,16,36,0.444,19,29,0.655,123,41,89,0.461,33,56,0.589,8,33,0.242,18,22,0.818,108
2094,2020/1/26,BRK,NYK,L 97-110,240,34,81,0.42,21,42,0.5,13,39,0.333,16,23,0.696,97,49,92,0.533,43,73,0.589,6,19,0.316,6,13,0.462,110
2095,2020/1/26,NYK,BRK,W 110-97,240,49,92,0.533,43,73,0.589,6,19,0.316,6,13,0.462,110,34,81,0.42,21,42,0.5,13,39,0.333,16,23,0.696,97
2096,2020/1/26,LAC,ORL,W 112-97,240,37,79,0.468,24,49,0.49,13,30,0.433,25,29,0.862,112,34,95,0.358,27,63,0.429,7,32,0.219,22,32,0.688,97
2097,2020/1/26,ORL,LAC,L 97-112,240,34,95,0.358,27,63,0.429,7,32,0.219,22,32,0.688,97,37,79,0.468,24,49,0.49,13,30,0.433,25,29,0.862,112
2098,2020/1/26,IND,POR,L 129-139,240,48,93,0.516,35,65,0.538,13,28,0.464,20,21,0.952,129,49,90,0.544,29,55,0.527,20,35,0.571,21,25,0.84,139
2099,2020/1/26,POR,IND,W 139-129,240,49,90,0.544,29,55,0.527,20,35,0.571,21,25,0.84,139,48,93,0.516,35,65,0.538,13,28,0.464,20,21,0.952,129
2100,2020/1/26,SAS,TOR,L 106-110,240,34,82,0.415,18,45,0.4,16,37,0.432,22,24,0.917,106,41,99,0.414,25,49,0.51,16,50,0.32,12,15,0.8,110
2101,2020/1/26,TOR,SAS,W 110-106,240,41,99,0.414,25,49,0.51,16,50,0.32,12,15,0.8,110,34,82,0.415,18,45,0.4,16,37,0.432,22,24,0.917,106
2102,2020/1/25,CHI,CLE,W 118-106,240,44,85,0.518,32,52,0.615,12,33,0.364,18,24,0.75,118,42,84,0.5,29,54,0.537,13,30,0.433,9,11,0.818,106
2103,2020/1/25,CLE,CHI,L 106-118,240,42,84,0.5,29,54,0.537,13,30,0.433,9,11,0.818,106,44,85,0.518,32,52,0.615,12,33,0.364,18,24,0.75,118
2104,2020/1/25,BRK,DET,W 121-111 (OT),265,42,94,0.447,27,52,0.519,15,42,0.357,22,25,0.88,121,43,104,0.413,30,69,0.435,13,35,0.371,12,18,0.667,111
2105,2020/1/25,DET,BRK,L 111-121 (OT),265,43,104,0.413,30,69,0.435,13,35,0.371,12,18,0.667,111,42,94,0.447,27,52,0.519,15,42,0.357,22,25,0.88,121
2106,2020/1/25,MIN,OKC,L 104-113,240,40,90,0.444,28,47,0.596,12,43,0.279,12,18,0.667,104,39,80,0.488,28,56,0.5,11,24,0.458,24,25,0.96,113
2107,2020/1/25,OKC,MIN,W 113-104,240,39,80,0.488,28,56,0.5,11,24,0.458,24,25,0.96,113,40,90,0.444,28,47,0.596,12,43,0.279,12,18,0.667,104
2108,2020/1/25,LAL,PHI,L 91-108,240,35,76,0.461,29,45,0.644,6,31,0.194,15,23,0.652,91,41,78,0.526,28,41,0.683,13,37,0.351,13,19,0.684,108
2109,2020/1/25,PHI,LAL,W 108-91,240,41,78,0.526,28,41,0.683,13,37,0.351,13,19,0.684,108,35,76,0.461,29,45,0.644,6,31,0.194,15,23,0.652,91
2110,2020/1/25,DAL,UTA,L 107-112,240,42,97,0.433,26,56,0.464,16,41,0.39,7,13,0.538,107,40,91,0.44,25,48,0.521,15,43,0.349,17,22,0.773,112
2111,2020/1/25,UTA,DAL,W 112-107,240,40,91,0.44,25,48,0.521,15,43,0.349,17,22,0.773,112,42,97,0.433,26,56,0.464,16,41,0.39,7,13,0.538,107
2112,2020/1/24,CHI,SAC,L 81-98,240,31,79,0.392,23,42,0.548,8,37,0.216,11,14,0.786,81,35,81,0.432,25,49,0.51,10,32,0.313,18,21,0.857,98
2113,2020/1/24,SAC,CHI,W 98-81,240,35,81,0.432,25,49,0.51,10,32,0.313,18,21,0.857,98,31,79,0.392,23,42,0.548,8,37,0.216,11,14,0.786,81
2114,2020/1/24,CHO,MIL,L 103-116,240,32,86,0.372,18,47,0.383,14,39,0.359,25,30,0.833,103,44,87,0.506,34,51,0.667,10,36,0.278,18,24,0.75,116
2115,2020/1/24,MIL,CHO,W 116-103,240,44,87,0.506,34,51,0.667,10,36,0.278,18,24,0.75,116,32,86,0.372,18,47,0.383,14,39,0.359,25,30,0.833,103
2116,2020/1/24,DET,MEM,L 112-125,240,39,91,0.429,28,59,0.475,11,32,0.344,23,31,0.742,112,43,79,0.544,32,57,0.561,11,22,0.5,28,31,0.903,125
2117,2020/1/24,MEM,DET,W 125-112,240,43,79,0.544,32,57,0.561,11,22,0.5,28,31,0.903,125,39,91,0.429,28,59,0.475,11,32,0.344,23,31,0.742,112
2118,2020/1/24,GSW,IND,L 118-129,240,40,82,0.488,21,43,0.488,19,39,0.487,19,23,0.826,118,50,87,0.575,33,59,0.559,17,28,0.607,12,13,0.923,129
2119,2020/1/24,IND,GSW,W 129-118,240,50,87,0.575,33,59,0.559,17,28,0.607,12,13,0.923,129,40,82,0.488,21,43,0.488,19,39,0.487,19,23,0.826,118
2120,2020/1/24,LAC,MIA,W 122-117,240,43,94,0.457,27,59,0.458,16,35,0.457,20,23,0.87,122,40,93,0.43,27,49,0.551,13,44,0.295,24,29,0.828,117
2121,2020/1/24,MIA,LAC,L 117-122,240,40,93,0.43,27,49,0.551,13,44,0.295,24,29,0.828,117,43,94,0.457,27,59,0.458,16,35,0.457,20,23,0.87,122
2122,2020/1/24,HOU,MIN,W 131-124,240,47,91,0.516,36,59,0.61,11,32,0.344,26,31,0.839,131,48,98,0.49,37,66,0.561,11,32,0.344,17,20,0.85,124
2123,2020/1/24,MIN,HOU,L 124-131,240,48,98,0.49,37,66,0.561,11,32,0.344,17,20,0.85,124,47,91,0.516,36,59,0.61,11,32,0.344,26,31,0.839,131
2124,2020/1/24,DEN,NOP,W 113-106,240,40,106,0.377,27,65,0.415,13,41,0.317,20,20,1,113,38,82,0.463,26,55,0.473,12,27,0.444,18,30,0.6,106
2125,2020/1/24,NOP,DEN,L 106-113,240,38,82,0.463,26,55,0.473,12,27,0.444,18,30,0.6,106,40,106,0.377,27,65,0.415,13,41,0.317,20,20,1,113
2126,2020/1/24,NYK,TOR,L 112-118,240,42,85,0.494,29,49,0.592,13,36,0.361,15,21,0.714,112,41,81,0.506,24,46,0.522,17,35,0.486,19,23,0.826,118
2127,2020/1/24,TOR,NYK,W 118-112,240,41,81,0.506,24,46,0.522,17,35,0.486,19,23,0.826,118,42,85,0.494,29,49,0.592,13,36,0.361,15,21,0.714,112
2128,2020/1/24,ATL,OKC,L 111-140,240,42,92,0.457,31,56,0.554,11,36,0.306,16,20,0.8,111,50,86,0.581,36,61,0.59,14,25,0.56,26,34,0.765,140
2129,2020/1/24,OKC,ATL,W 140-111,240,50,86,0.581,36,61,0.59,14,25,0.56,26,34,0.765,140,42,92,0.457,31,56,0.554,11,36,0.306,16,20,0.8,111
2130,2020/1/24,BOS,ORL,W 109-98,240,40,86,0.465,26,51,0.51,14,35,0.4,15,18,0.833,109,36,90,0.4,24,53,0.453,12,37,0.324,14,19,0.737,98
2131,2020/1/24,ORL,BOS,L 98-109,240,36,90,0.4,24,53,0.453,12,37,0.324,14,19,0.737,98,40,86,0.465,26,51,0.51,14,35,0.4,15,18,0.833,109
2132,2020/1/24,PHO,SAS,W 103-99,240,39,84,0.464,31,55,0.564,8,29,0.276,17,21,0.81,103,33,78,0.423,28,53,0.528,5,25,0.2,28,33,0.848,99
2133,2020/1/24,SAS,PHO,L 99-103,240,33,78,0.423,28,53,0.528,5,25,0.2,28,33,0.848,99,39,84,0.464,31,55,0.564,8,29,0.276,17,21,0.81,103
2134,2020/1/23,BRK,LAL,L 113-128,240,40,91,0.44,19,45,0.422,21,46,0.457,12,15,0.8,113,47,94,0.5,28,56,0.5,19,38,0.5,15,20,0.75,128
2135,2020/1/23,LAL,BRK,W 128-113,240,47,94,0.5,28,56,0.5,19,38,0.5,15,20,0.75,128,40,91,0.44,19,45,0.422,21,46,0.457,12,15,0.8,113
2136,2020/1/23,CLE,WAS,L 112-124,240,44,96,0.458,33,63,0.524,11,33,0.333,13,17,0.765,112,47,85,0.553,31,49,0.633,16,36,0.444,14,18,0.778,124
2137,2020/1/23,WAS,CLE,W 124-112,240,47,85,0.553,31,49,0.633,16,36,0.444,14,18,0.778,124,44,96,0.458,33,63,0.524,11,33,0.333,13,17,0.765,112
2138,2020/1/23,DAL,POR,W 133-125,240,48,93,0.516,26,46,0.565,22,47,0.468,15,24,0.625,133,46,91,0.505,25,52,0.481,21,39,0.538,12,15,0.8,125
2139,2020/1/23,POR,DAL,L 125-133,240,46,91,0.505,25,52,0.481,21,39,0.538,12,15,0.8,125,48,93,0.516,26,46,0.565,22,47,0.468,15,24,0.625,133
2140,2020/1/22,ATL,LAC,W 102-95,240,36,102,0.353,25,67,0.373,11,35,0.314,19,23,0.826,102,33,78,0.423,29,57,0.509,4,21,0.19,25,39,0.641,95
2141,2020/1/22,LAC,ATL,L 95-102,240,33,78,0.423,29,57,0.509,4,21,0.19,25,39,0.641,95,36,102,0.353,25,67,0.373,11,35,0.314,19,23,0.826,102
2142,2020/1/22,BOS,MEM,W 119-95,240,45,89,0.506,31,57,0.544,14,32,0.438,15,20,0.75,119,36,85,0.424,25,53,0.472,11,32,0.344,12,15,0.8,95
2143,2020/1/22,MEM,BOS,L 95-119,240,36,85,0.424,25,53,0.472,11,32,0.344,12,15,0.8,95,45,89,0.506,31,57,0.544,14,32,0.438,15,20,0.75,119
2144,2020/1/22,CHI,MIN,W 117-110,240,39,84,0.464,30,54,0.556,9,30,0.3,30,37,0.811,117,41,86,0.477,26,42,0.619,15,44,0.341,13,24,0.542,110
2145,2020/1/22,MIN,CHI,L 110-117,240,41,86,0.477,26,42,0.619,15,44,0.341,13,24,0.542,110,39,84,0.464,30,54,0.556,9,30,0.3,30,37,0.811,117
2146,2020/1/22,DET,SAC,W 127-106,240,39,73,0.534,27,44,0.614,12,29,0.414,37,44,0.841,127,42,98,0.429,32,63,0.508,10,35,0.286,12,23,0.522,106
2147,2020/1/22,SAC,DET,L 106-127,240,42,98,0.429,32,63,0.508,10,35,0.286,12,23,0.522,106,39,73,0.534,27,44,0.614,12,29,0.414,37,44,0.841,127
2148,2020/1/22,GSW,UTA,L 96-129,240,35,88,0.398,29,65,0.446,6,23,0.261,20,24,0.833,96,50,93,0.538,33,53,0.623,17,40,0.425,12,23,0.522,129
2149,2020/1/22,UTA,GSW,W 129-96,240,50,93,0.538,33,53,0.623,17,40,0.425,12,23,0.522,129,35,88,0.398,29,65,0.446,6,23,0.261,20,24,0.833,96
2150,2020/1/22,DEN,HOU,L 105-121,240,42,92,0.457,32,64,0.5,10,28,0.357,11,15,0.733,105,42,89,0.472,29,60,0.483,13,29,0.448,24,28,0.857,121
2151,2020/1/22,HOU,DEN,W 121-105,240,42,89,0.472,29,60,0.483,13,29,0.448,24,28,0.857,121,42,92,0.457,32,64,0.5,10,28,0.357,11,15,0.733,105
2152,2020/1/22,MIA,WAS,W 134-129 (OT),265,43,85,0.506,26,52,0.5,17,33,0.515,31,36,0.861,134,50,99,0.505,37,57,0.649,13,42,0.31,16,20,0.8,129
2153,2020/1/22,WAS,MIA,L 129-134 (OT),265,50,99,0.505,37,57,0.649,13,42,0.31,16,20,0.8,129,43,85,0.506,26,52,0.5,17,33,0.515,31,36,0.861,134
2154,2020/1/22,NOP,SAS,L 117-121,240,39,84,0.464,25,48,0.521,14,36,0.389,25,32,0.781,117,45,89,0.506,34,62,0.548,11,27,0.407,20,25,0.8,121
2155,2020/1/22,SAS,NOP,W 121-117,240,45,89,0.506,34,62,0.548,11,27,0.407,20,25,0.8,121,39,84,0.464,25,48,0.521,14,36,0.389,25,32,0.781,117
2156,2020/1/22,LAL,NYK,W 100-92,240,36,82,0.439,27,55,0.491,9,27,0.333,19,28,0.679,100,36,88,0.409,25,54,0.463,11,34,0.324,9,13,0.692,92
2157,2020/1/22,NYK,LAL,L 92-100,240,36,88,0.409,25,54,0.463,11,34,0.324,9,13,0.692,92,36,82,0.439,27,55,0.491,9,27,0.333,19,28,0.679,100
2158,2020/1/22,OKC,ORL,W 120-114,240,46,76,0.605,37,57,0.649,9,19,0.474,19,23,0.826,120,44,92,0.478,30,57,0.526,14,35,0.4,12,16,0.75,114
2159,2020/1/22,ORL,OKC,L 114-120,240,44,92,0.478,30,57,0.526,14,35,0.4,12,16,0.75,114,46,76,0.605,37,57,0.649,9,19,0.474,19,23,0.826,120
2160,2020/1/22,IND,PHO,W 112-87,240,45,84,0.536,36,64,0.563,9,20,0.45,13,20,0.65,112,30,84,0.357,26,64,0.406,4,20,0.2,23,26,0.885,87
2161,2020/1/22,PHO,IND,L 87-112,240,30,84,0.357,26,64,0.406,4,20,0.2,23,26,0.885,87,45,84,0.536,36,64,0.563,9,20,0.45,13,20,0.65,112
2162,2020/1/22,PHI,TOR,L 95-107,240,32,84,0.381,14,38,0.368,18,46,0.391,13,18,0.722,95,40,86,0.465,27,53,0.509,13,33,0.394,14,21,0.667,107
2163,2020/1/22,TOR,PHI,W 107-95,240,40,86,0.465,27,53,0.509,13,33,0.394,14,21,0.667,107,32,84,0.381,14,38,0.368,18,46,0.391,13,18,0.722,95
2164,2020/1/21,DAL,LAC,L 107-110,240,39,91,0.429,27,48,0.563,12,43,0.279,17,24,0.708,107,36,97,0.371,24,59,0.407,12,38,0.316,26,33,0.788,110
2165,2020/1/21,LAC,DAL,W 110-107,240,36,97,0.371,24,59,0.407,12,38,0.316,26,33,0.788,110,39,91,0.429,27,48,0.563,12,43,0.279,17,24,0.708,107
2166,2020/1/20,ATL,TOR,L 117-122,240,41,83,0.494,29,50,0.58,12,33,0.364,23,33,0.697,117,38,92,0.413,25,50,0.5,13,42,0.31,33,43,0.767,122
2167,2020/1/20,TOR,ATL,W 122-117,240,38,92,0.413,25,50,0.5,13,42,0.31,33,43,0.767,122,41,83,0.494,29,50,0.58,12,33,0.364,23,33,0.697,117
2168,2020/1/20,BOS,LAL,W 139-107,240,52,93,0.559,36,59,0.61,16,34,0.471,19,29,0.655,139,39,89,0.438,32,63,0.508,7,26,0.269,22,29,0.759,107
2169,2020/1/20,LAL,BOS,L 107-139,240,39,89,0.438,32,63,0.508,7,26,0.269,22,29,0.759,107,52,93,0.559,36,59,0.61,16,34,0.471,19,29,0.655,139
2170,2020/1/20,BRK,PHI,L 111-117,240,39,81,0.481,28,52,0.538,11,29,0.379,22,34,0.647,111,42,94,0.447,29,55,0.527,13,39,0.333,20,27,0.741,117
2171,2020/1/20,PHI,BRK,W 117-111,240,42,94,0.447,29,55,0.527,13,39,0.333,20,27,0.741,117,39,81,0.481,28,52,0.538,11,29,0.379,22,34,0.647,111
2172,2020/1/20,CHO,ORL,L 83-106,240,29,76,0.382,19,43,0.442,10,33,0.303,15,20,0.75,83,44,92,0.478,30,64,0.469,14,28,0.5,4,9,0.444,106
2173,2020/1/20,ORL,CHO,W 106-83,240,44,92,0.478,30,64,0.469,14,28,0.5,4,9,0.444,106,29,76,0.382,19,43,0.442,10,33,0.303,15,20,0.75,83
2174,2020/1/20,CLE,NYK,L 86-106,240,32,94,0.34,21,61,0.344,11,33,0.333,11,17,0.647,86,41,85,0.482,32,62,0.516,9,23,0.391,15,17,0.882,106
2175,2020/1/20,NYK,CLE,W 106-86,240,41,85,0.482,32,62,0.516,9,23,0.391,15,17,0.882,106,32,94,0.34,21,61,0.344,11,33,0.333,11,17,0.647,86
2176,2020/1/20,HOU,OKC,L 107-112,240,43,97,0.443,34,52,0.654,9,45,0.2,12,17,0.706,107,40,92,0.435,28,60,0.467,12,32,0.375,20,26,0.769,112
2177,2020/1/20,OKC,HOU,W 112-107,240,40,92,0.435,28,60,0.467,12,32,0.375,20,26,0.769,112,43,97,0.443,34,52,0.654,9,45,0.2,12,17,0.706,107
2178,2020/1/20,MEM,NOP,L 116-126,240,46,103,0.447,37,70,0.529,9,33,0.273,15,21,0.714,116,42,88,0.477,21,40,0.525,21,48,0.438,21,24,0.875,126
2179,2020/1/20,NOP,MEM,W 126-116,240,42,88,0.477,21,40,0.525,21,48,0.438,21,24,0.875,126,46,103,0.447,37,70,0.529,9,33,0.273,15,21,0.714,116
2180,2020/1/20,MIA,SAC,W 118-113 (OT),265,42,83,0.506,26,41,0.634,16,42,0.381,18,22,0.818,118,44,106,0.415,31,55,0.564,13,51,0.255,12,15,0.8,113
2181,2020/1/20,SAC,MIA,L 113-118 (OT),265,44,106,0.415,31,55,0.564,13,51,0.255,12,15,0.8,113,42,83,0.506,26,41,0.634,16,42,0.381,18,22,0.818,118
2182,2020/1/20,CHI,MIL,L 98-111,240,34,92,0.37,20,44,0.455,14,48,0.292,16,18,0.889,98,45,77,0.584,34,51,0.667,11,26,0.423,10,23,0.435,111
2183,2020/1/20,MIL,CHI,W 111-98,240,45,77,0.584,34,51,0.667,11,26,0.423,10,23,0.435,111,34,92,0.37,20,44,0.455,14,48,0.292,16,18,0.889,98
2184,2020/1/20,DEN,MIN,W 107-100,240,43,90,0.478,32,59,0.542,11,31,0.355,10,12,0.833,107,38,91,0.418,25,49,0.51,13,42,0.31,11,14,0.786,100
2185,2020/1/20,MIN,DEN,L 100-107,240,38,91,0.418,25,49,0.51,13,42,0.31,11,14,0.786,100,43,90,0.478,32,59,0.542,11,31,0.355,10,12,0.833,107
2186,2020/1/20,PHO,SAS,L 118-120,240,42,80,0.525,34,58,0.586,8,22,0.364,26,30,0.867,118,43,87,0.494,26,56,0.464,17,31,0.548,17,22,0.773,120
2187,2020/1/20,SAS,PHO,W 120-118,240,43,87,0.494,26,56,0.464,17,31,0.548,17,22,0.773,120,42,80,0.525,34,58,0.586,8,22,0.364,26,30,0.867,118
2188,2020/1/20,GSW,POR,L 124-129 (OT),265,48,116,0.414,39,80,0.488,9,36,0.25,19,22,0.864,124,44,100,0.44,30,56,0.536,14,44,0.318,27,30,0.9,129
2189,2020/1/20,POR,GSW,W 129-124 (OT),265,44,100,0.44,30,56,0.536,14,44,0.318,27,30,0.9,129,48,116,0.414,39,80,0.488,9,36,0.25,19,22,0.864,124
2190,2020/1/20,IND,UTA,L 88-118,240,39,93,0.419,32,67,0.478,7,26,0.269,3,7,0.429,88,47,87,0.54,35,56,0.625,12,31,0.387,12,12,1,118
2191,2020/1/20,UTA,IND,W 118-88,240,47,87,0.54,35,56,0.625,12,31,0.387,12,12,1,118,39,93,0.419,32,67,0.478,7,26,0.269,3,7,0.429,88
2192,2020/1/20,DET,WAS,L 100-106,240,38,89,0.427,28,57,0.491,10,32,0.313,14,20,0.7,100,42,82,0.512,33,58,0.569,9,24,0.375,13,16,0.813,106
2193,2020/1/20,WAS,DET,W 106-100,240,42,82,0.512,33,58,0.569,9,24,0.375,13,16,0.813,106,38,89,0.427,28,57,0.491,10,32,0.313,14,20,0.7,100
2194,2020/1/19,DEN,IND,L 107-115,240,41,88,0.466,38,65,0.585,3,23,0.13,22,32,0.688,107,43,86,0.5,30,57,0.526,13,29,0.448,16,19,0.842,115
2195,2020/1/19,IND,DEN,W 115-107,240,43,86,0.5,30,57,0.526,13,29,0.448,16,19,0.842,115,41,88,0.466,38,65,0.585,3,23,0.13,22,32,0.688,107
2196,2020/1/19,MIA,SAS,L 102-107,240,37,86,0.43,27,52,0.519,10,34,0.294,18,20,0.9,102,36,85,0.424,24,52,0.462,12,33,0.364,23,24,0.958,107
2197,2020/1/19,SAS,MIA,W 107-102,240,36,85,0.424,24,52,0.462,12,33,0.364,23,24,0.958,107,37,86,0.43,27,52,0.519,10,34,0.294,18,20,0.9,102
2198,2020/1/18,ATL,DET,L 103-136,240,40,93,0.43,30,59,0.508,10,34,0.294,13,15,0.867,103,51,86,0.593,36,54,0.667,15,32,0.469,19,25,0.76,136
2199,2020/1/18,DET,ATL,W 136-103,240,51,86,0.593,36,54,0.667,15,32,0.469,19,25,0.76,136,40,93,0.43,30,59,0.508,10,34,0.294,13,15,0.867,103
2200,2020/1/18,BOS,PHO,L 119-123,240,42,96,0.438,27,54,0.5,15,42,0.357,20,22,0.909,119,42,89,0.472,29,58,0.5,13,31,0.419,26,30,0.867,123
2201,2020/1/18,PHO,BOS,W 123-119,240,42,89,0.472,29,58,0.5,13,31,0.419,26,30,0.867,123,42,96,0.438,27,54,0.5,15,42,0.357,20,22,0.909,119
2202,2020/1/18,BRK,MIL,L 97-117,240,33,99,0.333,18,50,0.36,15,49,0.306,16,17,0.941,97,45,89,0.506,28,52,0.538,17,37,0.459,10,16,0.625,117
2203,2020/1/18,MIL,BRK,W 117-97,240,45,89,0.506,28,52,0.538,17,37,0.459,10,16,0.625,117,33,99,0.333,18,50,0.36,15,49,0.306,16,17,0.941,97
2204,2020/1/18,CHI,CLE,W 118-116,240,48,87,0.552,39,62,0.629,9,25,0.36,13,17,0.765,118,40,73,0.548,25,44,0.568,15,29,0.517,21,23,0.913,116
2205,2020/1/18,CLE,CHI,L 116-118,240,40,73,0.548,25,44,0.568,15,29,0.517,21,23,0.913,116,48,87,0.552,39,62,0.629,9,25,0.36,13,17,0.765,118
2206,2020/1/18,GSW,ORL,W 109-95,240,43,94,0.457,31,54,0.574,12,40,0.3,11,11,1,109,39,86,0.453,30,55,0.545,9,31,0.29,8,13,0.615,95
2207,2020/1/18,ORL,GSW,L 95-109,240,39,86,0.453,30,55,0.545,9,31,0.29,8,13,0.615,95,43,94,0.457,31,54,0.574,12,40,0.3,11,11,1,109
2208,2020/1/18,HOU,LAL,L 115-124,240,40,90,0.444,28,53,0.528,12,37,0.324,23,29,0.793,115,45,93,0.484,34,60,0.567,11,33,0.333,23,32,0.719,124
2209,2020/1/18,LAL,HOU,W 124-115,240,45,93,0.484,34,60,0.567,11,33,0.333,23,32,0.719,124,40,90,0.444,28,53,0.528,12,37,0.324,23,29,0.793,115
2210,2020/1/18,MIN,TOR,L 112-122,240,38,94,0.404,24,44,0.545,14,50,0.28,22,27,0.815,112,47,91,0.516,34,56,0.607,13,35,0.371,15,17,0.882,122
2211,2020/1/18,TOR,MIN,W 122-112,240,47,91,0.516,34,56,0.607,13,35,0.371,15,17,0.882,122,38,94,0.404,24,44,0.545,14,50,0.28,22,27,0.815,112
2212,2020/1/18,LAC,NOP,W 133-130,240,46,93,0.495,36,62,0.581,10,31,0.323,31,39,0.795,133,46,86,0.535,31,45,0.689,15,41,0.366,23,36,0.639,130
2213,2020/1/18,NOP,LAC,L 130-133,240,46,86,0.535,31,45,0.689,15,41,0.366,23,36,0.639,130,46,93,0.495,36,62,0.581,10,31,0.323,31,39,0.795,133
2214,2020/1/18,NYK,PHI,L 87-90,240,35,88,0.398,29,63,0.46,6,25,0.24,11,18,0.611,87,34,78,0.436,24,46,0.522,10,32,0.313,12,19,0.632,90
2215,2020/1/18,PHI,NYK,W 90-87,240,34,78,0.436,24,46,0.522,10,32,0.313,12,19,0.632,90,35,88,0.398,29,63,0.46,6,25,0.24,11,18,0.611,87
2216,2020/1/18,OKC,POR,W 119-106,240,43,83,0.518,36,61,0.59,7,22,0.318,26,36,0.722,119,39,91,0.429,27,59,0.458,12,32,0.375,16,21,0.762,106
2217,2020/1/18,POR,OKC,L 106-119,240,39,91,0.429,27,59,0.458,12,32,0.375,16,21,0.762,106,43,83,0.518,36,61,0.59,7,22,0.318,26,36,0.722,119
2218,2020/1/18,SAC,UTA,L 101-123,240,42,86,0.488,32,60,0.533,10,26,0.385,7,12,0.583,101,43,85,0.506,29,43,0.674,14,42,0.333,23,24,0.958,123
2219,2020/1/18,UTA,SAC,W 123-101,240,43,85,0.506,29,43,0.674,14,42,0.333,23,24,0.958,123,42,86,0.488,32,60,0.533,10,26,0.385,7,12,0.583,101
2220,2020/1/17,DAL,POR,W 120-112,240,39,89,0.438,19,42,0.452,20,47,0.426,22,28,0.786,120,44,85,0.518,35,55,0.636,9,30,0.3,15,22,0.682,112
2221,2020/1/17,POR,DAL,L 112-120,240,44,85,0.518,35,55,0.636,9,30,0.3,15,22,0.682,112,39,89,0.438,19,42,0.452,20,47,0.426,22,28,0.786,120
2222,2020/1/17,IND,MIN,W 116-114,240,46,82,0.561,38,58,0.655,8,24,0.333,16,20,0.8,116,40,88,0.455,23,49,0.469,17,39,0.436,17,21,0.81,114
2223,2020/1/17,MIN,IND,L 114-116,240,40,88,0.455,23,49,0.469,17,39,0.436,17,21,0.81,114,46,82,0.561,38,58,0.655,8,24,0.333,16,20,0.8,116
2224,2020/1/17,CLE,MEM,L 109-113,240,41,92,0.446,32,56,0.571,9,36,0.25,18,26,0.692,109,45,89,0.506,36,61,0.59,9,28,0.321,14,20,0.7,113
2225,2020/1/17,MEM,CLE,W 113-109,240,45,89,0.506,36,61,0.59,9,28,0.321,14,20,0.7,113,41,92,0.446,32,56,0.571,9,36,0.25,18,26,0.692,109
2226,2020/1/17,MIA,OKC,W 115-108,240,41,84,0.488,27,48,0.563,14,36,0.389,19,24,0.792,115,37,84,0.44,19,38,0.5,18,46,0.391,16,18,0.889,108
2227,2020/1/17,OKC,MIA,L 108-115,240,37,84,0.44,19,38,0.5,18,46,0.391,16,18,0.889,108,41,84,0.488,27,48,0.563,14,36,0.389,19,24,0.792,115
2228,2020/1/17,CHI,PHI,L 89-100,240,35,81,0.432,27,46,0.587,8,35,0.229,11,15,0.733,89,40,82,0.488,31,53,0.585,9,29,0.31,11,11,1,100
2229,2020/1/17,PHI,CHI,W 100-89,240,40,82,0.488,31,53,0.585,9,29,0.31,11,11,1,100,35,81,0.432,27,46,0.587,8,35,0.229,11,15,0.733,89
2230,2020/1/17,ATL,SAS,W 121-120,240,41,82,0.5,22,42,0.524,19,40,0.475,20,27,0.741,121,45,98,0.459,37,69,0.536,8,29,0.276,22,23,0.957,120
2231,2020/1/17,SAS,ATL,L 120-121,240,45,98,0.459,37,69,0.536,8,29,0.276,22,23,0.957,120,41,82,0.5,22,42,0.524,19,40,0.475,20,27,0.741,121
2232,2020/1/17,TOR,WAS,W 140-111,240,52,91,0.571,30,48,0.625,22,43,0.512,14,16,0.875,140,40,89,0.449,25,54,0.463,15,35,0.429,16,23,0.696,111
2233,2020/1/17,WAS,TOR,L 111-140,240,40,89,0.449,25,54,0.463,15,35,0.429,16,23,0.696,111,52,91,0.571,30,48,0.625,22,43,0.512,14,16,0.875,140
2234,2020/1/16,DEN,GSW,W 134-131 (OT),265,47,100,0.47,30,65,0.462,17,35,0.486,23,26,0.885,134,42,95,0.442,22,50,0.44,20,45,0.444,27,31,0.871,131
2235,2020/1/16,GSW,DEN,L 131-134 (OT),265,42,95,0.442,22,50,0.44,20,45,0.444,27,31,0.871,131,47,100,0.47,30,65,0.462,17,35,0.486,23,26,0.885,134
2236,2020/1/16,LAC,ORL,W 122-95,240,47,95,0.495,33,63,0.524,14,32,0.438,14,20,0.7,122,36,92,0.391,22,50,0.44,14,42,0.333,9,16,0.563,95
2237,2020/1/16,ORL,LAC,L 95-122,240,36,92,0.391,22,50,0.44,14,42,0.333,9,16,0.563,95,47,95,0.495,33,63,0.524,14,32,0.438,14,20,0.7,122
2238,2020/1/16,BOS,MIL,L 123-128,240,43,98,0.439,28,49,0.571,15,49,0.306,22,27,0.815,123,43,87,0.494,27,56,0.482,16,31,0.516,26,37,0.703,128
2239,2020/1/16,MIL,BOS,W 128-123,240,43,87,0.494,27,56,0.482,16,31,0.516,26,37,0.703,128,43,98,0.439,28,49,0.571,15,49,0.306,22,27,0.815,123
2240,2020/1/16,NOP,UTA,W 138-132 (OT),265,51,93,0.548,40,67,0.597,11,26,0.423,25,35,0.714,138,46,100,0.46,31,61,0.508,15,39,0.385,25,32,0.781,132
2241,2020/1/16,UTA,NOP,L 132-138 (OT),265,46,100,0.46,31,61,0.508,15,39,0.385,25,32,0.781,132,51,93,0.548,40,67,0.597,11,26,0.423,25,35,0.714,138
2242,2020/1/16,NYK,PHO,L 98-121,240,37,90,0.411,29,64,0.453,8,26,0.308,16,24,0.667,98,47,92,0.511,35,62,0.565,12,30,0.4,15,18,0.833,121
2243,2020/1/16,PHO,NYK,W 121-98,240,47,92,0.511,35,62,0.565,12,30,0.4,15,18,0.833,121,37,90,0.411,29,64,0.453,8,26,0.308,16,24,0.667,98
2244,2020/1/15,BOS,DET,L 103-116,240,41,83,0.494,32,55,0.582,9,28,0.321,12,20,0.6,103,47,78,0.603,35,46,0.761,12,32,0.375,10,19,0.526,116
2245,2020/1/15,DET,BOS,W 116-103,240,47,78,0.603,35,46,0.761,12,32,0.375,10,19,0.526,116,41,83,0.494,32,55,0.582,9,28,0.321,12,20,0.6,103
2246,2020/1/15,CHI,WAS,W 115-106,240,43,85,0.506,29,47,0.617,14,38,0.368,15,22,0.682,115,37,79,0.468,26,52,0.5,11,27,0.407,21,26,0.808,106
2247,2020/1/15,WAS,CHI,L 106-115,240,37,79,0.468,26,52,0.5,11,27,0.407,21,26,0.808,106,43,85,0.506,29,47,0.617,14,38,0.368,15,22,0.682,115
2248,2020/1/15,CHO,DEN,L 86-100,240,33,81,0.407,21,46,0.457,12,35,0.343,8,14,0.571,86,38,79,0.481,29,51,0.569,9,28,0.321,15,25,0.6,100
2249,2020/1/15,DEN,CHO,W 100-86,240,38,79,0.481,29,51,0.569,9,28,0.321,15,25,0.6,100,33,81,0.407,21,46,0.457,12,35,0.343,8,14,0.571,86
2250,2020/1/15,HOU,POR,L 107-117,240,38,96,0.396,22,47,0.468,16,49,0.327,15,23,0.652,107,41,95,0.432,30,59,0.508,11,36,0.306,24,29,0.828,117
2251,2020/1/15,POR,HOU,W 117-107,240,41,95,0.432,30,59,0.508,11,36,0.306,24,29,0.828,117,38,96,0.396,22,47,0.468,16,49,0.327,15,23,0.652,107
2252,2020/1/15,LAL,ORL,L 118-119,240,48,97,0.495,33,59,0.559,15,38,0.395,7,11,0.636,118,43,94,0.457,33,68,0.485,10,26,0.385,23,29,0.793,119
2253,2020/1/15,ORL,LAL,W 119-118,240,43,94,0.457,33,68,0.485,10,26,0.385,23,29,0.793,119,48,97,0.495,33,59,0.559,15,38,0.395,7,11,0.636,118
2254,2020/1/15,MIA,SAS,W 106-100,240,41,88,0.466,24,48,0.5,17,40,0.425,7,13,0.538,106,39,89,0.438,29,56,0.518,10,33,0.303,12,15,0.8,100
2255,2020/1/15,SAS,MIA,L 100-106,240,39,89,0.438,29,56,0.518,10,33,0.303,12,15,0.8,100,41,88,0.466,24,48,0.5,17,40,0.425,7,13,0.538,106
2256,2020/1/15,IND,MIN,W 104-99,240,44,85,0.518,37,62,0.597,7,23,0.304,9,12,0.75,104,38,88,0.432,27,60,0.45,11,28,0.393,12,16,0.75,99
2257,2020/1/15,MIN,IND,L 99-104,240,38,88,0.432,27,60,0.45,11,28,0.393,12,16,0.75,99,44,85,0.518,37,62,0.597,7,23,0.304,9,12,0.75,104
2258,2020/1/15,OKC,TOR,L 121-130,240,43,85,0.506,27,43,0.628,16,42,0.381,19,20,0.95,121,52,85,0.612,37,58,0.638,15,27,0.556,11,15,0.733,130
2259,2020/1/15,TOR,OKC,W 130-121,240,52,85,0.612,37,58,0.638,15,27,0.556,11,15,0.733,130,43,85,0.506,27,43,0.628,16,42,0.381,19,20,0.95,121
2260,2020/1/15,BRK,PHI,L 106-117,240,38,87,0.437,26,62,0.419,12,25,0.48,18,30,0.6,106,45,88,0.511,34,58,0.586,11,30,0.367,16,25,0.64,117
2261,2020/1/15,PHI,BRK,W 117-106,240,45,88,0.511,34,58,0.586,11,30,0.367,16,25,0.64,117,38,87,0.437,26,62,0.419,12,25,0.48,18,30,0.6,106
2262,2020/1/15,DAL,SAC,W 127-123,240,47,92,0.511,34,52,0.654,13,40,0.325,20,24,0.833,127,50,96,0.521,38,63,0.603,12,33,0.364,11,20,0.55,123
2263,2020/1/15,SAC,DAL,L 123-127,240,50,96,0.521,38,63,0.603,12,33,0.364,11,20,0.55,123,47,92,0.511,34,52,0.654,13,40,0.325,20,24,0.833,127
2264,2020/1/14,ATL,PHO,W 123-110,240,46,93,0.495,32,62,0.516,14,31,0.452,17,20,0.85,123,40,87,0.46,36,67,0.537,4,20,0.2,26,32,0.813,110
2265,2020/1/14,PHO,ATL,L 110-123,240,40,87,0.46,36,67,0.537,4,20,0.2,26,32,0.813,110,46,93,0.495,32,62,0.516,14,31,0.452,17,20,0.85,123
2266,2020/1/14,BRK,UTA,L 107-118,240,45,90,0.5,37,64,0.578,8,26,0.308,9,15,0.6,107,46,92,0.5,33,56,0.589,13,36,0.361,13,15,0.867,118
2267,2020/1/14,UTA,BRK,W 118-107,240,46,92,0.5,33,56,0.589,13,36,0.361,13,15,0.867,118,45,90,0.5,37,64,0.578,8,26,0.308,9,15,0.6,107
2268,2020/1/14,DAL,GSW,W 124-97,240,49,96,0.51,36,59,0.61,13,37,0.351,13,21,0.619,124,39,87,0.448,30,55,0.545,9,32,0.281,10,13,0.769,97
2269,2020/1/14,GSW,DAL,L 97-124,240,39,87,0.448,30,55,0.545,9,32,0.281,10,13,0.769,97,49,96,0.51,36,59,0.61,13,37,0.351,13,21,0.619,124
2270,2020/1/14,CLE,LAC,L 103-128,240,38,91,0.418,24,54,0.444,14,37,0.378,13,15,0.867,103,49,94,0.521,34,56,0.607,15,38,0.395,15,21,0.714,128
2271,2020/1/14,LAC,CLE,W 128-103,240,49,94,0.521,34,56,0.607,15,38,0.395,15,21,0.714,128,38,91,0.418,24,54,0.444,14,37,0.378,13,15,0.867,103
2272,2020/1/14,HOU,MEM,L 110-121,240,37,86,0.43,23,41,0.561,14,45,0.311,22,24,0.917,110,46,91,0.505,33,54,0.611,13,37,0.351,16,19,0.842,121
2273,2020/1/14,MEM,HOU,W 121-110,240,46,91,0.505,33,54,0.611,13,37,0.351,16,19,0.842,121,37,86,0.43,23,41,0.561,14,45,0.311,22,24,0.917,110
2274,2020/1/14,MIL,NYK,W 128-102,240,45,92,0.489,30,56,0.536,15,36,0.417,23,28,0.821,128,36,102,0.353,25,65,0.385,11,37,0.297,19,26,0.731,102
2275,2020/1/14,NYK,MIL,L 102-128,240,36,102,0.353,25,65,0.385,11,37,0.297,19,26,0.731,102,45,92,0.489,30,56,0.536,15,36,0.417,23,28,0.821,128
2276,2020/1/13,BOS,CHI,W 113-101,240,39,83,0.47,30,60,0.5,9,23,0.391,26,29,0.897,113,37,81,0.457,31,56,0.554,6,25,0.24,21,26,0.808,101
2277,2020/1/13,CHI,BOS,L 101-113,240,37,81,0.457,31,56,0.554,6,25,0.24,21,26,0.808,101,39,83,0.47,30,60,0.5,9,23,0.391,26,29,0.897,113
2278,2020/1/13,DET,NOP,L 110-117 (OT),265,40,99,0.404,29,67,0.433,11,32,0.344,19,24,0.792,110,43,103,0.417,34,77,0.442,9,26,0.346,22,27,0.815,117
2279,2020/1/13,NOP,DET,W 117-110 (OT),265,43,103,0.417,34,77,0.442,9,26,0.346,22,27,0.815,117,40,99,0.404,29,67,0.433,11,32,0.344,19,24,0.792,110
2280,2020/1/13,IND,PHI,W 101-95,240,33,86,0.384,23,60,0.383,10,26,0.385,25,31,0.806,101,37,89,0.416,31,56,0.554,6,33,0.182,15,19,0.789,95
2281,2020/1/13,PHI,IND,L 95-101,240,37,89,0.416,31,56,0.554,6,33,0.182,15,19,0.789,95,33,86,0.384,23,60,0.383,10,26,0.385,25,31,0.806,101
2282,2020/1/13,CLE,LAL,L 99-128,240,38,85,0.447,31,60,0.517,7,25,0.28,16,24,0.667,99,48,88,0.545,37,58,0.638,11,30,0.367,21,28,0.75,128
2283,2020/1/13,LAL,CLE,W 128-99,240,48,88,0.545,37,58,0.638,11,30,0.367,21,28,0.75,128,38,85,0.447,31,60,0.517,7,25,0.28,16,24,0.667,99
2284,2020/1/13,MIN,OKC,L 104-117,240,38,91,0.418,26,56,0.464,12,35,0.343,16,21,0.762,104,41,82,0.5,29,52,0.558,12,30,0.4,23,26,0.885,117
2285,2020/1/13,OKC,MIN,W 117-104,240,41,82,0.5,29,52,0.558,12,30,0.4,23,26,0.885,117,38,91,0.418,26,56,0.464,12,35,0.343,16,21,0.762,104
2286,2020/1/13,CHO,POR,L 112-115,240,40,90,0.444,22,52,0.423,18,38,0.474,14,18,0.778,112,42,83,0.506,26,46,0.565,16,37,0.432,15,19,0.789,115
2287,2020/1/13,POR,CHO,W 115-112,240,42,83,0.506,26,46,0.565,16,37,0.432,15,19,0.789,115,40,90,0.444,22,52,0.423,18,38,0.474,14,18,0.778,112
2288,2020/1/13,ORL,SAC,W 114-112,240,40,92,0.435,31,63,0.492,9,29,0.31,25,30,0.833,114,45,87,0.517,33,56,0.589,12,31,0.387,10,11,0.909,112
2289,2020/1/13,SAC,ORL,L 112-114,240,45,87,0.517,33,56,0.589,12,31,0.387,10,11,0.909,112,40,92,0.435,31,63,0.492,9,29,0.31,25,30,0.833,114
2290,2020/1/12,ATL,BRK,L 86-108,240,32,97,0.33,20,49,0.408,12,48,0.25,10,11,0.909,86,41,77,0.532,31,51,0.608,10,26,0.385,16,29,0.552,108
2291,2020/1/12,BRK,ATL,W 108-86,240,41,77,0.532,31,51,0.608,10,26,0.385,16,29,0.552,108,32,97,0.33,20,49,0.408,12,48,0.25,10,11,0.909,86
2292,2020/1/12,DEN,LAC,W 114-104,240,37,77,0.481,26,52,0.5,11,25,0.44,29,37,0.784,114,38,84,0.452,30,51,0.588,8,33,0.242,20,26,0.769,104
2293,2020/1/12,LAC,DEN,L 104-114,240,38,84,0.452,30,51,0.588,8,33,0.242,20,26,0.769,104,37,77,0.481,26,52,0.5,11,25,0.44,29,37,0.784,114
2294,2020/1/12,GSW,MEM,L 102-122,240,35,92,0.38,18,58,0.31,17,34,0.5,15,21,0.714,102,45,100,0.45,34,65,0.523,11,35,0.314,21,25,0.84,122
2295,2020/1/12,MEM,GSW,W 122-102,240,45,100,0.45,34,65,0.523,11,35,0.314,21,25,0.84,122,35,92,0.38,18,58,0.31,17,34,0.5,15,21,0.714,102
2296,2020/1/12,MIA,NYK,L 121-124,240,42,78,0.538,28,43,0.651,14,35,0.4,23,28,0.821,121,46,90,0.511,37,59,0.627,9,31,0.29,23,28,0.821,124
2297,2020/1/12,NYK,MIA,W 124-121,240,46,90,0.511,37,59,0.627,9,31,0.29,23,28,0.821,124,42,78,0.538,28,43,0.651,14,35,0.4,23,28,0.821,121
2298,2020/1/12,CHO,PHO,L 92-100,240,36,86,0.419,28,51,0.549,8,35,0.229,12,18,0.667,92,41,82,0.5,34,61,0.557,7,21,0.333,11,18,0.611,100
2299,2020/1/12,PHO,CHO,W 100-92,240,41,82,0.5,34,61,0.557,7,21,0.333,11,18,0.611,100,36,86,0.419,28,51,0.549,8,35,0.229,12,18,0.667,92
2300,2020/1/12,SAS,TOR,W 105-104,240,38,87,0.437,31,55,0.564,7,32,0.219,22,30,0.733,105,39,96,0.406,22,48,0.458,17,48,0.354,9,11,0.818,104
2301,2020/1/12,TOR,SAS,L 104-105,240,39,96,0.406,22,48,0.458,17,48,0.354,9,11,0.818,104,38,87,0.437,31,55,0.564,7,32,0.219,22,30,0.733,105
2302,2020/1/12,UTA,WAS,W 127-116,240,48,90,0.533,38,60,0.633,10,30,0.333,21,25,0.84,127,47,93,0.505,40,71,0.563,7,22,0.318,15,17,0.882,116
2303,2020/1/12,WAS,UTA,L 116-127,240,47,93,0.505,40,71,0.563,7,22,0.318,15,17,0.882,116,48,90,0.533,38,60,0.633,10,30,0.333,21,25,0.84,127
2304,2020/1/11,BOS,NOP,W 140-105,240,55,100,0.55,41,71,0.577,14,29,0.483,16,18,0.889,140,40,100,0.4,26,55,0.473,14,45,0.311,11,18,0.611,105
2305,2020/1/11,NOP,BOS,L 105-140,240,40,100,0.4,26,55,0.473,14,45,0.311,11,18,0.611,105,55,100,0.55,41,71,0.577,14,29,0.483,16,18,0.889,140
2306,2020/1/11,DAL,PHI,W 109-91,240,40,79,0.506,29,52,0.558,11,27,0.407,18,27,0.667,109,37,98,0.378,28,61,0.459,9,37,0.243,8,12,0.667,91
2307,2020/1/11,PHI,DAL,L 91-109,240,37,98,0.378,28,61,0.459,9,37,0.243,8,12,0.667,91,40,79,0.506,29,52,0.558,11,27,0.407,18,27,0.667,109
2308,2020/1/11,CLE,DEN,W 111-103,240,44,89,0.494,32,52,0.615,12,37,0.324,11,13,0.846,111,41,95,0.432,33,56,0.589,8,39,0.205,13,18,0.722,103
2309,2020/1/11,DEN,CLE,L 103-111,240,41,95,0.432,33,56,0.589,8,39,0.205,13,18,0.722,103,44,89,0.494,32,52,0.615,12,37,0.324,11,13,0.846,111
2310,2020/1/11,CHI,DET,W 108-99,240,42,83,0.506,31,48,0.646,11,35,0.314,13,14,0.929,108,36,78,0.462,27,50,0.54,9,28,0.321,18,27,0.667,99
2311,2020/1/11,DET,CHI,L 99-108,240,36,78,0.462,27,50,0.54,9,28,0.321,18,27,0.667,99,42,83,0.506,31,48,0.646,11,35,0.314,13,14,0.929,108
2312,2020/1/11,HOU,MIN,W 139-109,240,49,95,0.516,31,50,0.62,18,45,0.4,23,29,0.793,139,36,95,0.379,23,47,0.489,13,48,0.271,24,36,0.667,109
2313,2020/1/11,MIN,HOU,L 109-139,240,36,95,0.379,23,47,0.489,13,48,0.271,24,36,0.667,109,49,95,0.516,31,50,0.62,18,45,0.4,23,29,0.793,139
2314,2020/1/11,LAL,OKC,W 125-110,240,51,99,0.515,36,67,0.537,15,32,0.469,8,10,0.8,125,43,92,0.467,34,61,0.557,9,31,0.29,15,17,0.882,110
2315,2020/1/11,OKC,LAL,L 110-125,240,43,92,0.467,34,61,0.557,9,31,0.29,15,17,0.882,110,51,99,0.515,36,67,0.537,15,32,0.469,8,10,0.8,125
2316,2020/1/11,MIL,POR,W 122-101,240,47,103,0.456,33,65,0.508,14,38,0.368,14,20,0.7,122,37,95,0.389,27,59,0.458,10,36,0.278,17,21,0.81,101
2317,2020/1/11,POR,MIL,L 101-122,240,37,95,0.389,27,59,0.458,10,36,0.278,17,21,0.81,101,47,103,0.456,33,65,0.508,14,38,0.368,14,20,0.7,122
2318,2020/1/10,BRK,MIA,W 117-113,240,45,93,0.484,30,49,0.612,15,44,0.341,12,19,0.632,117,44,85,0.518,37,56,0.661,7,29,0.241,18,21,0.857,113
2319,2020/1/10,MIA,BRK,L 113-117,240,44,85,0.518,37,56,0.661,7,29,0.241,18,21,0.857,113,45,93,0.484,30,49,0.612,15,44,0.341,12,19,0.632,117
2320,2020/1/10,CHI,IND,L 105-116,240,37,80,0.463,19,39,0.487,18,41,0.439,13,16,0.813,105,48,84,0.571,37,54,0.685,11,30,0.367,9,14,0.643,116
2321,2020/1/10,IND,CHI,W 116-105,240,48,84,0.571,37,54,0.685,11,30,0.367,9,14,0.643,116,37,80,0.463,19,39,0.487,18,41,0.439,13,16,0.813,105
2322,2020/1/10,DAL,LAL,L 114-129,240,39,96,0.406,28,58,0.483,11,38,0.289,25,37,0.676,114,47,89,0.528,37,65,0.569,10,24,0.417,25,32,0.781,129
2323,2020/1/10,LAL,DAL,W 129-114,240,47,89,0.528,37,65,0.569,10,24,0.417,25,32,0.781,129,39,96,0.406,28,58,0.483,11,38,0.289,25,37,0.676,114
2324,2020/1/10,GSW,LAC,L 100-109,240,37,96,0.385,29,57,0.509,8,39,0.205,18,25,0.72,100,41,84,0.488,30,45,0.667,11,39,0.282,16,22,0.727,109
2325,2020/1/10,LAC,GSW,W 109-100,240,41,84,0.488,30,45,0.667,11,39,0.282,16,22,0.727,109,37,96,0.385,29,57,0.509,8,39,0.205,18,25,0.72,100
2326,2020/1/10,MEM,SAS,W 134-121,240,52,100,0.52,36,62,0.581,16,38,0.421,14,16,0.875,134,42,87,0.483,25,47,0.532,17,40,0.425,20,23,0.87,121
2327,2020/1/10,SAS,MEM,L 121-134,240,42,87,0.483,25,47,0.532,17,40,0.425,20,23,0.87,121,52,100,0.52,36,62,0.581,16,38,0.421,14,16,0.875,134
2328,2020/1/10,NOP,NYK,W 123-111,240,48,86,0.558,30,48,0.625,18,38,0.474,9,17,0.529,123,46,100,0.46,41,73,0.562,5,27,0.185,14,20,0.7,111
2329,2020/1/10,NYK,NOP,L 111-123,240,46,100,0.46,41,73,0.562,5,27,0.185,14,20,0.7,111,48,86,0.558,30,48,0.625,18,38,0.474,9,17,0.529,123
2330,2020/1/10,ORL,PHO,L 94-98,240,33,89,0.371,24,56,0.429,9,33,0.273,19,24,0.792,94,33,79,0.418,24,51,0.471,9,28,0.321,23,26,0.885,98
2331,2020/1/10,PHO,ORL,W 98-94,240,33,79,0.418,24,51,0.471,9,28,0.321,23,26,0.885,98,33,89,0.371,24,56,0.429,9,33,0.273,19,24,0.792,94
2332,2020/1/10,MIL,SAC,W 127-106,240,47,95,0.495,37,56,0.661,10,39,0.256,23,30,0.767,127,44,96,0.458,34,61,0.557,10,35,0.286,8,10,0.8,106
2333,2020/1/10,SAC,MIL,L 106-127,240,44,96,0.458,34,61,0.557,10,35,0.286,8,10,0.8,106,47,95,0.495,37,56,0.661,10,39,0.256,23,30,0.767,127
2334,2020/1/10,CHO,UTA,L 92-109,240,35,75,0.467,27,49,0.551,8,26,0.308,14,19,0.737,92,40,79,0.506,22,37,0.595,18,42,0.429,11,14,0.786,109
2335,2020/1/10,UTA,CHO,W 109-92,240,40,79,0.506,22,37,0.595,18,42,0.429,11,14,0.786,109,35,75,0.467,27,49,0.551,8,26,0.308,14,19,0.737,92
2336,2020/1/10,ATL,WAS,L 101-111,240,41,89,0.461,34,60,0.567,7,29,0.241,12,24,0.5,101,42,112,0.375,32,83,0.386,10,29,0.345,17,28,0.607,111
2337,2020/1/10,WAS,ATL,W 111-101,240,42,112,0.375,32,83,0.386,10,29,0.345,17,28,0.607,111,41,89,0.461,34,60,0.567,7,29,0.241,12,24,0.5,101
2338,2020/1/9,CLE,DET,W 115-112 (OT),265,48,91,0.527,43,71,0.606,5,20,0.25,14,20,0.7,115,48,98,0.49,42,78,0.538,6,20,0.3,10,16,0.625,112
2339,2020/1/9,DET,CLE,L 112-115 (OT),265,48,98,0.49,42,78,0.538,6,20,0.3,10,16,0.625,112,48,91,0.527,43,71,0.606,5,20,0.25,14,20,0.7,115
2340,2020/1/9,MIN,POR,W 116-102,240,44,89,0.494,31,57,0.544,13,32,0.406,15,21,0.714,116,35,96,0.365,24,59,0.407,11,37,0.297,21,31,0.677,102
2341,2020/1/9,POR,MIN,L 102-116,240,35,96,0.365,24,59,0.407,11,37,0.297,21,31,0.677,102,44,89,0.494,31,57,0.544,13,32,0.406,15,21,0.714,116
2342,2020/1/9,HOU,OKC,L 92-113,240,34,89,0.382,23,49,0.469,11,40,0.275,13,14,0.929,92,43,87,0.494,32,55,0.582,11,32,0.344,16,20,0.8,113
2343,2020/1/9,OKC,HOU,W 113-92,240,43,87,0.494,32,55,0.582,11,32,0.344,16,20,0.8,113,34,89,0.382,23,49,0.469,11,40,0.275,13,14,0.929,92
2344,2020/1/9,BOS,PHI,L 98-109,240,38,88,0.432,24,52,0.462,14,36,0.389,8,8,1,98,43,88,0.489,32,61,0.525,11,27,0.407,12,17,0.706,109
2345,2020/1/9,PHI,BOS,W 109-98,240,43,88,0.489,32,61,0.525,11,27,0.407,12,17,0.706,109,38,88,0.432,24,52,0.462,14,36,0.389,8,8,1,98
2346,2020/1/8,ATL,HOU,L 115-122,240,39,106,0.368,26,62,0.419,13,44,0.295,24,27,0.889,115,39,92,0.424,26,47,0.553,13,45,0.289,31,41,0.756,122
2347,2020/1/8,HOU,ATL,W 122-115,240,39,92,0.424,26,47,0.553,13,45,0.289,31,41,0.756,122,39,106,0.368,26,62,0.419,13,44,0.295,24,27,0.889,115
2348,2020/1/8,BOS,SAS,L 114-129,240,37,89,0.416,24,51,0.471,13,38,0.342,27,30,0.9,114,48,87,0.552,39,58,0.672,9,29,0.31,24,26,0.923,129
2349,2020/1/8,SAS,BOS,W 129-114,240,48,87,0.552,39,58,0.672,9,29,0.31,24,26,0.923,129,37,89,0.416,24,51,0.471,13,38,0.342,27,30,0.9,114
2350,2020/1/8,CHO,TOR,L 110-112 (OT),265,38,86,0.442,23,49,0.469,15,37,0.405,19,26,0.731,110,42,94,0.447,28,58,0.483,14,36,0.389,14,20,0.7,112
2351,2020/1/8,TOR,CHO,W 112-110 (OT),265,42,94,0.447,28,58,0.483,14,36,0.389,14,20,0.7,112,38,86,0.442,23,49,0.469,15,37,0.405,19,26,0.731,110
2352,2020/1/8,DAL,DEN,L 106-107,240,39,77,0.506,27,42,0.643,12,35,0.343,16,24,0.667,106,41,85,0.482,32,61,0.525,9,24,0.375,16,20,0.8,107
2353,2020/1/8,DEN,DAL,W 107-106,240,41,85,0.482,32,61,0.525,9,24,0.375,16,20,0.8,107,39,77,0.506,27,42,0.643,12,35,0.343,16,24,0.667,106
2354,2020/1/8,GSW,MIL,L 98-107,240,33,87,0.379,18,49,0.367,15,38,0.395,17,20,0.85,98,35,87,0.402,26,46,0.565,9,41,0.22,28,32,0.875,107
2355,2020/1/8,MIL,GSW,W 107-98,240,35,87,0.402,26,46,0.565,9,41,0.22,28,32,0.875,107,33,87,0.379,18,49,0.367,15,38,0.395,17,20,0.85,98
2356,2020/1/8,IND,MIA,L 108-122,240,40,84,0.476,31,57,0.544,9,27,0.333,19,25,0.76,108,43,81,0.531,27,43,0.628,16,38,0.421,20,25,0.8,122
2357,2020/1/8,MIA,IND,W 122-108,240,43,81,0.531,27,43,0.628,16,38,0.421,20,25,0.8,122,40,84,0.476,31,57,0.544,9,27,0.333,19,25,0.76,108
2358,2020/1/8,CHI,NOP,L 108-123,240,41,92,0.446,27,57,0.474,14,35,0.4,12,21,0.571,108,41,87,0.471,26,43,0.605,15,44,0.341,26,32,0.813,123
2359,2020/1/8,NOP,CHI,W 123-108,240,41,87,0.471,26,43,0.605,15,44,0.341,26,32,0.813,123,41,92,0.446,27,57,0.474,14,35,0.4,12,21,0.571,108
2360,2020/1/8,ORL,WAS,W 123-89,240,43,87,0.494,33,60,0.55,10,27,0.37,27,34,0.794,123,36,84,0.429,30,61,0.492,6,23,0.261,11,19,0.579,89
2361,2020/1/8,WAS,ORL,L 89-123,240,36,84,0.429,30,61,0.492,6,23,0.261,11,19,0.579,89,43,87,0.494,33,60,0.55,10,27,0.37,27,34,0.794,123
2362,2020/1/8,NYK,UTA,L 104-128,240,42,97,0.433,33,72,0.458,9,25,0.36,11,11,1,104,49,90,0.544,33,47,0.702,16,43,0.372,14,23,0.609,128
2363,2020/1/8,UTA,NYK,W 128-104,240,49,90,0.544,33,47,0.702,16,43,0.372,14,23,0.609,128,42,97,0.433,33,72,0.458,9,25,0.36,11,11,1,104
2364,2020/1/7,BRK,OKC,L 103-111 (OT),265,40,98,0.408,29,61,0.475,11,37,0.297,12,16,0.75,103,38,92,0.413,27,55,0.491,11,37,0.297,24,29,0.828,111
2365,2020/1/7,OKC,BRK,W 111-103 (OT),265,38,92,0.413,27,55,0.491,11,37,0.297,24,29,0.828,111,40,98,0.408,29,61,0.475,11,37,0.297,12,16,0.75,103
2366,2020/1/7,CLE,DET,L 113-115,240,42,85,0.494,28,54,0.519,14,31,0.452,15,16,0.938,113,42,91,0.462,29,58,0.5,13,33,0.394,18,21,0.857,115
2367,2020/1/7,DET,CLE,W 115-113,240,42,91,0.462,29,58,0.5,13,33,0.394,18,21,0.857,115,42,85,0.494,28,54,0.519,14,31,0.452,15,16,0.938,113
2368,2020/1/7,LAL,NYK,W 117-87,240,41,82,0.5,24,46,0.522,17,36,0.472,18,21,0.857,117,37,95,0.389,33,75,0.44,4,20,0.2,9,16,0.563,87
2369,2020/1/7,NYK,LAL,L 87-117,240,37,95,0.389,33,75,0.44,4,20,0.2,9,16,0.563,87,41,82,0.5,24,46,0.522,17,36,0.472,18,21,0.857,117
2370,2020/1/7,MEM,MIN,W 119-112,240,46,89,0.517,38,61,0.623,8,28,0.286,19,21,0.905,119,40,90,0.444,25,43,0.581,15,47,0.319,17,21,0.81,112
2371,2020/1/7,MIN,MEM,L 112-119,240,40,90,0.444,25,43,0.581,15,47,0.319,17,21,0.81,112,46,89,0.517,38,61,0.623,8,28,0.286,19,21,0.905,119
2372,2020/1/7,PHO,SAC,L 103-114,240,37,77,0.481,26,42,0.619,11,35,0.314,18,22,0.818,103,37,84,0.44,22,48,0.458,15,36,0.417,25,28,0.893,114
2373,2020/1/7,SAC,PHO,W 114-103,240,37,84,0.44,22,48,0.458,15,36,0.417,25,28,0.893,114,37,77,0.481,26,42,0.619,11,35,0.314,18,22,0.818,103
2374,2020/1/7,POR,TOR,W 101-99,240,38,88,0.432,25,53,0.472,13,35,0.371,12,14,0.857,101,35,96,0.365,20,54,0.37,15,42,0.357,14,19,0.737,99
2375,2020/1/7,TOR,POR,L 99-101,240,35,96,0.365,20,54,0.37,15,42,0.357,14,19,0.737,99,38,88,0.432,25,53,0.472,13,35,0.371,12,14,0.857,101
2376,2020/1/6,ATL,DEN,L 115-123,240,35,77,0.455,17,38,0.447,18,39,0.462,27,32,0.844,115,47,92,0.511,38,65,0.585,9,27,0.333,20,27,0.741,123
2377,2020/1/6,DEN,ATL,W 123-115,240,47,92,0.511,38,65,0.585,9,27,0.333,20,27,0.741,123,35,77,0.455,17,38,0.447,18,39,0.462,27,32,0.844,115
2378,2020/1/6,CHO,IND,L 104-115,240,37,81,0.457,27,51,0.529,10,30,0.333,20,22,0.909,104,47,89,0.528,37,63,0.587,10,26,0.385,11,14,0.786,115
2379,2020/1/6,IND,CHO,W 115-104,240,47,89,0.528,37,63,0.587,10,26,0.385,11,14,0.786,115,37,81,0.457,27,51,0.529,10,30,0.333,20,22,0.909,104
2380,2020/1/6,CHI,DAL,L 110-118,240,46,98,0.469,37,67,0.552,9,31,0.29,9,11,0.818,110,44,84,0.524,28,43,0.651,16,41,0.39,14,19,0.737,118
2381,2020/1/6,DAL,CHI,W 118-110,240,44,84,0.524,28,43,0.651,16,41,0.39,14,19,0.737,118,46,98,0.469,37,67,0.552,9,31,0.29,9,11,0.818,110
2382,2020/1/6,NOP,UTA,L 126-128,240,45,94,0.479,33,63,0.524,12,31,0.387,24,30,0.8,126,46,90,0.511,30,57,0.526,16,33,0.485,20,24,0.833,128
2383,2020/1/6,UTA,NOP,W 128-126,240,46,90,0.511,30,57,0.526,16,33,0.485,20,24,0.833,128,45,94,0.479,33,63,0.524,12,31,0.387,24,30,0.8,126
2384,2020/1/6,BRK,ORL,L 89-101,240,32,96,0.333,22,49,0.449,10,47,0.213,15,19,0.789,89,35,81,0.432,27,55,0.491,8,26,0.308,23,31,0.742,101
2385,2020/1/6,ORL,BRK,W 101-89,240,35,81,0.432,27,55,0.491,8,26,0.308,23,31,0.742,101,32,96,0.333,22,49,0.449,10,47,0.213,15,19,0.789,89
2386,2020/1/6,OKC,PHI,L 113-120,240,40,89,0.449,28,60,0.467,12,29,0.414,21,31,0.677,113,46,90,0.511,33,64,0.516,13,26,0.5,15,18,0.833,120
2387,2020/1/6,PHI,OKC,W 120-113,240,46,90,0.511,33,64,0.516,13,26,0.5,15,18,0.833,120,40,89,0.449,28,60,0.467,12,29,0.414,21,31,0.677,113
2388,2020/1/6,GSW,SAC,L 98-111,240,34,86,0.395,29,60,0.483,5,26,0.192,25,32,0.781,98,39,81,0.481,24,51,0.471,15,30,0.5,18,23,0.783,111
2389,2020/1/6,SAC,GSW,W 111-98,240,39,81,0.481,24,51,0.471,15,30,0.5,18,23,0.783,111,34,86,0.395,29,60,0.483,5,26,0.192,25,32,0.781,98
2390,2020/1/6,MIL,SAS,L 104-126,240,38,95,0.4,23,50,0.46,15,45,0.333,13,14,0.929,104,45,88,0.511,26,53,0.491,19,35,0.543,17,19,0.895,126
2391,2020/1/6,SAS,MIL,W 126-104,240,45,88,0.511,26,53,0.491,19,35,0.543,17,19,0.895,126,38,95,0.4,23,50,0.46,15,45,0.333,13,14,0.929,104
2392,2020/1/6,BOS,WAS,L 94-99,240,33,95,0.347,25,58,0.431,8,37,0.216,20,26,0.769,94,39,84,0.464,32,63,0.508,7,21,0.333,14,23,0.609,99
2393,2020/1/6,WAS,BOS,W 99-94,240,39,84,0.464,32,63,0.508,7,21,0.333,14,23,0.609,99,33,95,0.347,25,58,0.431,8,37,0.216,20,26,0.769,94
2394,2020/1/5,CLE,MIN,L 103-118,240,40,84,0.476,32,59,0.542,8,25,0.32,15,19,0.789,103,47,95,0.495,33,57,0.579,14,38,0.368,10,13,0.769,118
2395,2020/1/5,MIN,CLE,W 118-103,240,47,95,0.495,33,57,0.579,14,38,0.368,10,13,0.769,118,40,84,0.476,32,59,0.542,8,25,0.32,15,19,0.789,103
2396,2020/1/5,LAC,NYK,W 135-132,240,45,83,0.542,27,51,0.529,18,32,0.563,27,33,0.818,135,48,84,0.571,36,61,0.59,12,23,0.522,24,37,0.649,132
2397,2020/1/5,NYK,LAC,L 132-135,240,48,84,0.571,36,61,0.59,12,23,0.522,24,37,0.649,132,45,83,0.542,27,51,0.529,18,32,0.563,27,33,0.818,135
2398,2020/1/5,DET,LAL,L 99-106,240,29,78,0.372,18,52,0.346,11,26,0.423,30,35,0.857,99,42,92,0.457,36,72,0.5,6,20,0.3,16,23,0.696,106
2399,2020/1/5,LAL,DET,W 106-99,240,42,92,0.457,36,72,0.5,6,20,0.3,16,23,0.696,106,29,78,0.372,18,52,0.346,11,26,0.423,30,35,0.857,99
2400,2020/1/5,MIA,POR,W 122-111,240,47,90,0.522,29,46,0.63,18,44,0.409,10,16,0.625,122,40,87,0.46,27,50,0.54,13,37,0.351,18,20,0.9,111
2401,2020/1/5,POR,MIA,L 111-122,240,40,87,0.46,27,50,0.54,13,37,0.351,18,20,0.9,111,47,90,0.522,29,46,0.63,18,44,0.409,10,16,0.625,122
2402,2020/1/5,MEM,PHO,W 121-114,240,45,83,0.542,27,41,0.659,18,42,0.429,13,17,0.765,121,43,95,0.453,37,69,0.536,6,26,0.231,22,26,0.846,114
2403,2020/1/5,PHO,MEM,L 114-121,240,43,95,0.453,37,69,0.536,6,26,0.231,22,26,0.846,114,45,83,0.542,27,41,0.659,18,42,0.429,13,17,0.765,121
2404,2020/1/4,ATL,IND,W 116-111,240,42,82,0.512,32,50,0.64,10,32,0.313,22,24,0.917,116,36,87,0.414,26,60,0.433,10,27,0.37,29,35,0.829,111
2405,2020/1/4,IND,ATL,L 111-116,240,36,87,0.414,26,60,0.433,10,27,0.37,29,35,0.829,111,42,82,0.512,32,50,0.64,10,32,0.313,22,24,0.917,116
2406,2020/1/4,BRK,TOR,L 102-121,240,32,67,0.478,19,32,0.594,13,35,0.371,25,34,0.735,102,44,97,0.454,31,65,0.477,13,32,0.406,20,28,0.714,121
2407,2020/1/4,TOR,BRK,W 121-102,240,44,97,0.454,31,65,0.477,13,32,0.406,20,28,0.714,121,32,67,0.478,19,32,0.594,13,35,0.371,25,34,0.735,102
2408,2020/1/4,BOS,CHI,W 111-104,240,43,82,0.524,35,63,0.556,8,19,0.421,17,21,0.81,111,34,80,0.425,21,46,0.457,13,34,0.382,23,31,0.742,104
2409,2020/1/4,CHI,BOS,L 104-111,240,34,80,0.425,21,46,0.457,13,34,0.382,23,31,0.742,104,43,82,0.524,35,63,0.556,8,19,0.421,17,21,0.81,111
2410,2020/1/4,CLE,OKC,L 106-121,240,39,85,0.459,25,55,0.455,14,30,0.467,14,17,0.824,106,43,96,0.448,29,59,0.492,14,37,0.378,21,26,0.808,121
2411,2020/1/4,OKC,CLE,W 121-106,240,43,96,0.448,29,59,0.492,14,37,0.378,21,26,0.808,121,39,85,0.459,25,55,0.455,14,30,0.467,14,17,0.824,106
2412,2020/1/4,CHO,DAL,W 123-120 (OT),265,42,85,0.494,31,60,0.517,11,25,0.44,28,31,0.903,123,47,100,0.47,32,50,0.64,15,50,0.3,11,13,0.846,120
2413,2020/1/4,DAL,CHO,L 120-123 (OT),265,47,100,0.47,32,50,0.64,15,50,0.3,11,13,0.846,120,42,85,0.494,31,60,0.517,11,25,0.44,28,31,0.903,123
2414,2020/1/4,DET,GSW,W 111-104,240,43,83,0.518,32,56,0.571,11,27,0.407,14,16,0.875,111,33,82,0.402,22,61,0.361,11,21,0.524,27,32,0.844,104
2415,2020/1/4,GSW,DET,L 104-111,240,33,82,0.402,22,61,0.361,11,21,0.524,27,32,0.844,104,43,83,0.518,32,56,0.571,11,27,0.407,14,16,0.875,111
2416,2020/1/4,LAC,MEM,L 114-140,240,45,101,0.446,38,71,0.535,7,30,0.233,17,22,0.773,114,49,96,0.51,31,57,0.544,18,39,0.462,24,28,0.857,140
2417,2020/1/4,MEM,LAC,W 140-114,240,49,96,0.51,31,57,0.544,18,39,0.462,24,28,0.857,140,45,101,0.446,38,71,0.535,7,30,0.233,17,22,0.773,114
2418,2020/1/4,MIL,SAS,W 127-118,240,43,87,0.494,26,42,0.619,17,45,0.378,24,33,0.727,127,38,92,0.413,27,60,0.45,11,32,0.344,31,34,0.912,118
2419,2020/1/4,SAS,MIL,L 118-127,240,38,92,0.413,27,60,0.45,11,32,0.344,31,34,0.912,118,43,87,0.494,26,42,0.619,17,45,0.378,24,33,0.727,127
2420,2020/1/4,ORL,UTA,L 96-109,240,38,85,0.447,27,48,0.563,11,37,0.297,9,12,0.75,96,42,93,0.452,26,53,0.491,16,40,0.4,9,14,0.643,109
2421,2020/1/4,UTA,ORL,W 109-96,240,42,93,0.452,26,53,0.491,16,40,0.4,9,14,0.643,109,38,85,0.447,27,48,0.563,11,37,0.297,9,12,0.75,96
2422,2020/1/4,NOP,SAC,W 117-115,240,38,87,0.437,22,42,0.524,16,45,0.356,25,33,0.758,117,38,85,0.447,26,64,0.406,12,21,0.571,27,36,0.75,115
2423,2020/1/4,SAC,NOP,L 115-117,240,38,85,0.447,26,64,0.406,12,21,0.571,27,36,0.75,115,38,87,0.437,22,42,0.524,16,45,0.356,25,33,0.758,117
2424,2020/1/4,DEN,WAS,L 114-128,240,40,87,0.46,34,58,0.586,6,29,0.207,28,34,0.824,114,50,91,0.549,44,75,0.587,6,16,0.375,22,27,0.815,128
2425,2020/1/4,WAS,DEN,W 128-114,240,50,91,0.549,44,75,0.587,6,16,0.375,22,27,0.815,128,40,87,0.46,34,58,0.586,6,29,0.207,28,34,0.824,114
2426,2020/1/3,ATL,BOS,L 106-109,240,39,93,0.419,23,48,0.479,16,45,0.356,12,15,0.8,106,41,93,0.441,35,68,0.515,6,25,0.24,21,29,0.724,109
2427,2020/1/3,BOS,ATL,W 109-106,240,41,93,0.441,35,68,0.515,6,25,0.24,21,29,0.724,109,39,93,0.419,23,48,0.479,16,45,0.356,12,15,0.8,106
2428,2020/1/3,HOU,PHI,W 118-108,240,41,86,0.477,29,54,0.537,12,32,0.375,24,32,0.75,118,42,92,0.457,36,65,0.554,6,27,0.222,18,25,0.72,108
2429,2020/1/3,PHI,HOU,L 108-118,240,42,92,0.457,36,65,0.554,6,27,0.222,18,25,0.72,108,41,86,0.477,29,54,0.537,12,32,0.375,24,32,0.75,118
2430,2020/1/3,LAL,NOP,W 123-113,240,43,86,0.5,29,57,0.509,14,29,0.483,23,28,0.821,123,48,102,0.471,37,65,0.569,11,37,0.297,6,7,0.857,113
2431,2020/1/3,NOP,LAL,L 113-123,240,48,102,0.471,37,65,0.569,11,37,0.297,6,7,0.857,113,43,86,0.5,29,57,0.509,14,29,0.483,23,28,0.821,123
2432,2020/1/3,MIA,ORL,L 85-105,240,30,80,0.375,23,43,0.535,7,37,0.189,18,23,0.783,85,33,81,0.407,20,46,0.435,13,35,0.371,26,29,0.897,105
2433,2020/1/3,ORL,MIA,W 105-85,240,33,81,0.407,20,46,0.435,13,35,0.371,26,29,0.897,105,30,80,0.375,23,43,0.535,7,37,0.189,18,23,0.783,85
2434,2020/1/3,NYK,PHO,L 112-120,240,41,92,0.446,31,55,0.564,10,37,0.27,20,30,0.667,112,42,90,0.467,32,62,0.516,10,28,0.357,26,33,0.788,120
2435,2020/1/3,PHO,NYK,W 120-112,240,42,90,0.467,32,62,0.516,10,28,0.357,26,33,0.788,120,41,92,0.446,31,55,0.564,10,37,0.27,20,30,0.667,112
2436,2020/1/3,POR,WAS,W 122-103,240,45,88,0.511,39,63,0.619,6,25,0.24,26,33,0.788,122,38,90,0.422,27,57,0.474,11,33,0.333,16,25,0.64,103
2437,2020/1/3,WAS,POR,L 103-122,240,38,90,0.422,27,57,0.474,11,33,0.333,16,25,0.64,103,45,88,0.511,39,63,0.619,6,25,0.24,26,33,0.788,122
2438,2020/1/2,CHI,UTA,L 98-102,240,37,94,0.394,26,58,0.448,11,36,0.306,13,17,0.765,98,37,76,0.487,26,46,0.565,11,30,0.367,17,22,0.773,102
2439,2020/1/2,UTA,CHI,W 102-98,240,37,76,0.487,26,46,0.565,11,30,0.367,17,22,0.773,102,37,94,0.394,26,58,0.448,11,36,0.306,13,17,0.765,98
2440,2020/1/2,CHO,CLE,W 109-106,240,37,83,0.446,22,45,0.489,15,38,0.395,20,24,0.833,109,41,81,0.506,28,46,0.609,13,35,0.371,11,14,0.786,106
2441,2020/1/2,CLE,CHO,L 106-109,240,41,81,0.506,28,46,0.609,13,35,0.371,11,14,0.786,106,37,83,0.446,22,45,0.489,15,38,0.395,20,24,0.833,109
2442,2020/1/2,BRK,DAL,L 111-123,240,42,91,0.462,30,54,0.556,12,37,0.324,15,17,0.882,111,45,89,0.506,27,51,0.529,18,38,0.474,15,17,0.882,123
2443,2020/1/2,DAL,BRK,W 123-111,240,45,89,0.506,27,51,0.529,18,38,0.474,15,17,0.882,123,42,91,0.462,30,54,0.556,12,37,0.324,15,17,0.882,111
2444,2020/1/2,DEN,IND,W 124-116,240,46,87,0.529,38,60,0.633,8,27,0.296,24,27,0.889,124,43,82,0.524,31,56,0.554,12,26,0.462,18,25,0.72,116
2445,2020/1/2,IND,DEN,L 116-124,240,43,82,0.524,31,56,0.554,12,26,0.462,18,25,0.72,116,46,87,0.529,38,60,0.633,8,27,0.296,24,27,0.889,124
2446,2020/1/2,DET,LAC,L 112-126,240,40,94,0.426,33,61,0.541,7,33,0.212,25,35,0.714,112,50,92,0.543,39,64,0.609,11,28,0.393,15,21,0.714,126
2447,2020/1/2,LAC,DET,W 126-112,240,50,92,0.543,39,64,0.609,11,28,0.393,15,21,0.714,126,40,94,0.426,33,61,0.541,7,33,0.212,25,35,0.714,112
2448,2020/1/2,MIA,TOR,W 84-76,240,33,81,0.407,21,44,0.477,12,37,0.324,6,11,0.545,84,28,89,0.315,22,47,0.468,6,42,0.143,14,17,0.824,76
2449,2020/1/2,TOR,MIA,L 76-84,240,28,89,0.315,22,47,0.468,6,42,0.143,14,17,0.824,76,33,81,0.407,21,44,0.477,12,37,0.324,6,11,0.545,84
2450,2020/1/2,GSW,MIN,L 84-99,240,33,77,0.429,30,57,0.526,3,20,0.15,15,21,0.714,84,38,95,0.4,25,52,0.481,13,43,0.302,10,17,0.588,99
2451,2020/1/2,MIN,GSW,W 99-84,240,38,95,0.4,25,52,0.481,13,43,0.302,10,17,0.588,99,33,77,0.429,30,57,0.526,3,20,0.15,15,21,0.714,84
2452,2020/1/2,MEM,SAC,L 123-128,240,45,93,0.484,32,59,0.542,13,34,0.382,20,21,0.952,123,44,90,0.489,30,56,0.536,14,34,0.412,26,31,0.839,128
2453,2020/1/2,SAC,MEM,W 128-123,240,44,90,0.489,30,56,0.536,14,34,0.412,26,31,0.839,128,45,93,0.484,32,59,0.542,13,34,0.382,20,21,0.952,123
2454,2020/1/2,OKC,SAS,W 109-103,240,43,89,0.483,34,64,0.531,9,25,0.36,14,20,0.7,109,40,92,0.435,27,61,0.443,13,31,0.419,10,12,0.833,103
2455,2020/1/2,SAS,OKC,L 103-109,240,40,92,0.435,27,61,0.443,13,31,0.419,10,12,0.833,103,43,89,0.483,34,64,0.531,9,25,0.36,14,20,0.7,109
2456,2020/1/1,LAL,PHO,W 117-107,240,43,90,0.478,36,62,0.581,7,28,0.25,24,34,0.706,117,42,86,0.488,36,63,0.571,6,23,0.261,17,23,0.739,107
2457,2020/1/1,PHO,LAL,L 107-117,240,42,86,0.488,36,63,0.571,6,23,0.261,17,23,0.739,107,43,90,0.478,36,62,0.581,7,28,0.25,24,34,0.706,117
2458,2020/1/1,MIL,MIN,W 106-104,240,40,94,0.426,31,58,0.534,9,36,0.25,17,26,0.654,106,34,91,0.374,19,45,0.422,15,46,0.326,21,28,0.75,104
2459,2020/1/1,MIN,MIL,L 104-106,240,34,91,0.374,19,45,0.422,15,46,0.326,21,28,0.75,104,40,94,0.426,31,58,0.534,9,36,0.25,17,26,0.654,106
2460,2020/1/1,NYK,POR,W 117-93,240,47,98,0.48,33,62,0.532,14,36,0.389,9,14,0.643,117,37,94,0.394,27,62,0.435,10,32,0.313,9,15,0.6,93
2461,2020/1/1,POR,NYK,L 93-117,240,37,94,0.394,27,62,0.435,10,32,0.313,9,15,0.6,93,47,98,0.48,33,62,0.532,14,36,0.389,9,14,0.643,117
2462,2020/1/1,ORL,WAS,W 122-101,240,45,95,0.474,33,63,0.524,12,32,0.375,20,27,0.741,122,33,87,0.379,24,56,0.429,9,31,0.29,26,31,0.839,101
2463,2020/1/1,WAS,ORL,L 101-122,240,33,87,0.379,24,56,0.429,9,31,0.29,26,31,0.839,101,45,95,0.474,33,63,0.524,12,32,0.375,20,27,0.741,122
2464,2019/12/31,BOS,CHO,W 109-92,240,44,97,0.454,30,59,0.508,14,38,0.368,7,10,0.7,109,34,86,0.395,22,52,0.423,12,34,0.353,12,16,0.75,92
2465,2019/12/31,CHO,BOS,L 92-109,240,34,86,0.395,22,52,0.423,12,34,0.353,12,16,0.75,92,44,97,0.454,30,59,0.508,14,38,0.368,7,10,0.7,109
2466,2019/12/31,DEN,HOU,L 104-130,240,45,97,0.464,37,72,0.514,8,25,0.32,6,9,0.667,104,46,87,0.529,30,53,0.566,16,34,0.471,22,31,0.71,130
2467,2019/12/31,HOU,DEN,W 130-104,240,46,87,0.529,30,53,0.566,16,34,0.471,22,31,0.71,130,45,97,0.464,37,72,0.514,8,25,0.32,6,9,0.667,104
2468,2019/12/31,IND,PHI,W 115-97,240,42,86,0.488,31,61,0.508,11,25,0.44,20,26,0.769,115,37,91,0.407,31,62,0.5,6,29,0.207,17,20,0.85,97
2469,2019/12/31,PHI,IND,L 97-115,240,37,91,0.407,31,62,0.5,6,29,0.207,17,20,0.85,97,42,86,0.488,31,61,0.508,11,25,0.44,20,26,0.769,115
2470,2019/12/31,DAL,OKC,L 101-106,240,33,93,0.355,18,42,0.429,15,51,0.294,20,27,0.741,101,39,91,0.429,33,64,0.516,6,27,0.222,22,28,0.786,106
2471,2019/12/31,OKC,DAL,W 106-101,240,39,91,0.429,33,64,0.516,6,27,0.222,22,28,0.786,106,33,93,0.355,18,42,0.429,15,51,0.294,20,27,0.741,101
2472,2019/12/31,LAC,SAC,W 105-87,240,36,88,0.409,24,52,0.462,12,36,0.333,21,22,0.955,105,33,80,0.413,25,52,0.481,8,28,0.286,13,19,0.684,87
2473,2019/12/31,SAC,LAC,L 87-105,240,33,80,0.413,25,52,0.481,8,28,0.286,13,19,0.684,87,36,88,0.409,24,52,0.462,12,36,0.333,21,22,0.955,105
2474,2019/12/31,GSW,SAS,L 113-117 (OT),265,44,96,0.458,32,69,0.464,12,27,0.444,13,18,0.722,113,45,96,0.469,31,65,0.477,14,31,0.452,13,17,0.765,117
2475,2019/12/31,SAS,GSW,W 117-113 (OT),265,45,96,0.469,31,65,0.477,14,31,0.452,13,17,0.765,117,44,96,0.458,32,69,0.464,12,27,0.444,13,18,0.722,113
2476,2019/12/31,CLE,TOR,L 97-117,240,37,87,0.425,27,49,0.551,10,38,0.263,13,16,0.813,97,40,84,0.476,23,45,0.511,17,39,0.436,20,25,0.8,117
2477,2019/12/31,TOR,CLE,W 117-97,240,40,84,0.476,23,45,0.511,17,39,0.436,20,25,0.8,117,37,87,0.425,27,49,0.551,10,38,0.263,13,16,0.813,97
2478,2019/12/30,CHI,MIL,L 102-123,240,40,107,0.374,23,63,0.365,17,44,0.386,5,8,0.625,102,46,84,0.548,35,52,0.673,11,32,0.344,20,24,0.833,123
2479,2019/12/30,MIL,CHI,W 123-102,240,46,84,0.548,35,52,0.673,11,32,0.344,20,24,0.833,123,40,107,0.374,23,63,0.365,17,44,0.386,5,8,0.625,102
2480,2019/12/30,BRK,MIN,L 115-122 (OT),265,40,99,0.404,25,58,0.431,15,41,0.366,20,27,0.741,115,42,104,0.404,25,60,0.417,17,44,0.386,21,29,0.724,122
2481,2019/12/30,MIN,BRK,W 122-115 (OT),265,42,104,0.404,25,60,0.417,17,44,0.386,21,29,0.724,122,40,99,0.404,25,58,0.431,15,41,0.366,20,27,0.741,115
2482,2019/12/30,ATL,ORL,W 101-93,240,39,81,0.481,30,52,0.577,9,29,0.31,14,17,0.824,101,37,89,0.416,32,64,0.5,5,25,0.2,14,24,0.583,93
2483,2019/12/30,ORL,ATL,L 93-101,240,37,89,0.416,32,64,0.5,5,25,0.2,14,24,0.583,93,39,81,0.481,30,52,0.577,9,29,0.31,14,17,0.824,101
2484,2019/12/30,PHO,POR,W 122-116,240,44,92,0.478,31,69,0.449,13,23,0.565,21,22,0.955,122,44,96,0.458,30,62,0.484,14,34,0.412,14,18,0.778,116
2485,2019/12/30,POR,PHO,L 116-122,240,44,96,0.458,30,62,0.484,14,34,0.412,14,18,0.778,116,44,92,0.478,31,69,0.449,13,23,0.565,21,22,0.955,122
2486,2019/12/30,DET,UTA,L 81-104,240,30,79,0.38,26,65,0.4,4,14,0.286,17,23,0.739,81,39,83,0.47,29,57,0.509,10,26,0.385,16,20,0.8,104
2487,2019/12/30,UTA,DET,W 104-81,240,39,83,0.47,29,57,0.509,10,26,0.385,16,20,0.8,104,30,79,0.38,26,65,0.4,4,14,0.286,17,23,0.739,81
2488,2019/12/30,MIA,WAS,L 105-123,240,33,73,0.452,23,45,0.511,10,28,0.357,29,39,0.744,105,43,84,0.512,26,47,0.553,17,37,0.459,20,30,0.667,123
2489,2019/12/30,WAS,MIA,W 123-105,240,43,84,0.512,26,47,0.553,17,37,0.459,20,30,0.667,123,33,73,0.452,23,45,0.511,10,28,0.357,29,39,0.744,105
2490,2019/12/29,DEN,SAC,W 120-115,240,42,81,0.519,34,52,0.654,8,29,0.276,28,31,0.903,120,45,85,0.529,32,51,0.627,13,34,0.382,12,17,0.706,115
2491,2019/12/29,SAC,DEN,L 115-120,240,45,85,0.529,32,51,0.627,13,34,0.382,12,17,0.706,115,42,81,0.519,34,52,0.654,8,29,0.276,28,31,0.903,120
2492,2019/12/29,DAL,LAL,L 95-108,240,32,89,0.36,19,46,0.413,13,43,0.302,18,20,0.9,95,38,78,0.487,29,55,0.527,9,23,0.391,23,28,0.821,108
2493,2019/12/29,LAL,DAL,W 108-95,240,38,78,0.487,29,55,0.527,9,23,0.391,23,28,0.821,108,32,89,0.36,19,46,0.413,13,43,0.302,18,20,0.9,95
2494,2019/12/29,CHO,MEM,L 104-117,240,37,86,0.43,28,55,0.509,9,31,0.29,21,32,0.656,104,45,93,0.484,35,58,0.603,10,35,0.286,17,17,1,117
2495,2019/12/29,MEM,CHO,W 117-104,240,45,93,0.484,35,58,0.603,10,35,0.286,17,17,1,117,37,86,0.43,28,55,0.509,9,31,0.29,21,32,0.656,104
2496,2019/12/29,HOU,NOP,L 112-127,240,42,81,0.519,27,42,0.643,15,39,0.385,13,20,0.65,112,50,102,0.49,32,58,0.552,18,44,0.409,9,13,0.692,127
2497,2019/12/29,NOP,HOU,W 127-112,240,50,102,0.49,32,58,0.552,18,44,0.409,9,13,0.692,127,42,81,0.519,27,42,0.643,15,39,0.385,13,20,0.65,112
2498,2019/12/29,OKC,TOR,W 98-97,240,34,78,0.436,24,45,0.533,10,33,0.303,20,23,0.87,98,35,83,0.422,20,43,0.465,15,40,0.375,12,12,1,97
2499,2019/12/29,TOR,OKC,L 97-98,240,35,83,0.422,20,43,0.465,15,40,0.375,12,12,1,97,34,78,0.436,24,45,0.533,10,33,0.303,20,23,0.87,98
2500,2019/12/28,BOS,TOR,L 97-113,240,31,78,0.397,24,46,0.522,7,32,0.219,28,36,0.778,97,44,84,0.524,30,50,0.6,14,34,0.412,11,17,0.647,113
2501,2019/12/28,TOR,BOS,W 113-97,240,44,84,0.524,30,50,0.6,14,34,0.412,11,17,0.647,113,31,78,0.397,24,46,0.522,7,32,0.219,28,36,0.778,97
2502,2019/12/28,ATL,CHI,L 81-116,240,32,86,0.372,23,52,0.442,9,34,0.265,8,11,0.727,81,43,87,0.494,28,56,0.5,15,31,0.484,15,19,0.789,116
2503,2019/12/28,CHI,ATL,W 116-81,240,43,87,0.494,28,56,0.5,15,31,0.484,15,19,0.789,116,32,86,0.372,23,52,0.442,9,34,0.265,8,11,0.727,81
2504,2019/12/28,DEN,MEM,W 119-110,240,45,93,0.484,36,64,0.563,9,29,0.31,20,27,0.741,119,41,84,0.488,32,54,0.593,9,30,0.3,19,25,0.76,110
2505,2019/12/28,MEM,DEN,L 110-119,240,41,84,0.488,32,54,0.593,9,30,0.3,19,25,0.76,110,45,93,0.484,36,64,0.563,9,29,0.31,20,27,0.741,119
2506,2019/12/28,DAL,GSW,W 141-121,240,48,92,0.522,24,41,0.585,24,51,0.471,21,21,1,141,45,93,0.484,27,54,0.5,18,39,0.462,13,17,0.765,121
2507,2019/12/28,GSW,DAL,L 121-141,240,45,93,0.484,27,54,0.5,18,39,0.462,13,17,0.765,121,48,92,0.522,24,41,0.585,24,51,0.471,21,21,1,141
2508,2019/12/28,BRK,HOU,L 98-108,240,37,92,0.402,26,53,0.491,11,39,0.282,13,21,0.619,98,44,101,0.436,31,59,0.525,13,42,0.31,7,16,0.438,108
2509,2019/12/28,HOU,BRK,W 108-98,240,44,101,0.436,31,59,0.525,13,42,0.31,7,16,0.438,108,37,92,0.402,26,53,0.491,11,39,0.282,13,21,0.619,98
2510,2019/12/28,LAC,UTA,L 107-120,240,35,95,0.368,23,55,0.418,12,40,0.3,25,27,0.926,107,45,86,0.523,28,51,0.549,17,35,0.486,13,17,0.765,120
2511,2019/12/28,UTA,LAC,W 120-107,240,45,86,0.523,28,51,0.549,17,35,0.486,13,17,0.765,120,35,95,0.368,23,55,0.418,12,40,0.3,25,27,0.926,107
2512,2019/12/28,MIA,PHI,W 117-116 (OT),265,42,94,0.447,32,66,0.485,10,28,0.357,23,29,0.793,117,42,89,0.472,32,59,0.542,10,30,0.333,22,29,0.759,116
2513,2019/12/28,PHI,MIA,L 116-117 (OT),265,42,89,0.472,32,59,0.542,10,30,0.333,22,29,0.759,116,42,94,0.447,32,66,0.485,10,28,0.357,23,29,0.793,117
2514,2019/12/28,MIL,ORL,W 111-100,240,43,84,0.512,30,47,0.638,13,37,0.351,12,18,0.667,111,35,87,0.402,21,52,0.404,14,35,0.4,16,19,0.842,100
2515,2019/12/28,ORL,MIL,L 100-111,240,35,87,0.402,21,52,0.404,14,35,0.4,16,19,0.842,100,43,84,0.512,30,47,0.638,13,37,0.351,12,18,0.667,111
2516,2019/12/28,CLE,MIN,W 94-88,240,32,77,0.416,28,57,0.491,4,20,0.2,26,36,0.722,94,33,93,0.355,25,56,0.446,8,37,0.216,14,19,0.737,88
2517,2019/12/28,MIN,CLE,L 88-94,240,33,93,0.355,25,56,0.446,8,37,0.216,14,19,0.737,88,32,77,0.416,28,57,0.491,4,20,0.2,26,36,0.722,94
2518,2019/12/28,IND,NOP,L 98-120,240,33,85,0.388,27,57,0.474,6,28,0.214,26,29,0.897,98,43,93,0.462,25,51,0.49,18,42,0.429,16,20,0.8,120
2519,2019/12/28,NOP,IND,W 120-98,240,43,93,0.462,25,51,0.49,18,42,0.429,16,20,0.8,120,33,85,0.388,27,57,0.474,6,28,0.214,26,29,0.897,98
2520,2019/12/28,LAL,POR,W 128-120,240,47,91,0.516,36,59,0.61,11,32,0.344,23,28,0.821,128,41,86,0.477,26,51,0.51,15,35,0.429,23,27,0.852,120
2521,2019/12/28,POR,LAL,L 120-128,240,41,86,0.477,26,51,0.51,15,35,0.429,23,27,0.852,120,47,91,0.516,36,59,0.61,11,32,0.344,23,28,0.821,128
2522,2019/12/28,PHO,SAC,W 112-110,240,45,86,0.523,36,60,0.6,9,26,0.346,13,15,0.867,112,41,84,0.488,29,53,0.547,12,31,0.387,16,24,0.667,110
2523,2019/12/28,SAC,PHO,L 110-112,240,41,84,0.488,29,53,0.547,12,31,0.387,16,24,0.667,110,45,86,0.523,36,60,0.6,9,26,0.346,13,15,0.867,112
2524,2019/12/28,DET,SAS,L 109-136,240,40,90,0.444,28,54,0.519,12,36,0.333,17,30,0.567,109,53,93,0.57,35,58,0.603,18,35,0.514,12,15,0.8,136
2525,2019/12/28,SAS,DET,W 136-109,240,53,93,0.57,35,58,0.603,18,35,0.514,12,15,0.8,136,40,90,0.444,28,54,0.519,12,36,0.333,17,30,0.567,109
2526,2019/12/28,NYK,WAS,W 107-100,240,38,85,0.447,27,54,0.5,11,31,0.355,20,26,0.769,107,33,96,0.344,23,71,0.324,10,25,0.4,24,31,0.774,100
2527,2019/12/28,WAS,NYK,L 100-107,240,33,96,0.344,23,71,0.324,10,25,0.4,24,31,0.774,100,38,85,0.447,27,54,0.5,11,31,0.355,20,26,0.769,107
2528,2019/12/27,ATL,MIL,L 86-112,240,33,91,0.363,21,50,0.42,12,41,0.293,8,14,0.571,86,46,91,0.505,35,63,0.556,11,28,0.393,9,13,0.692,112
2529,2019/12/27,MIL,ATL,W 112-86,240,46,91,0.505,35,63,0.556,11,28,0.393,9,13,0.692,112,33,91,0.363,21,50,0.42,12,41,0.293,8,14,0.571,86
2530,2019/12/27,BOS,CLE,W 129-117,240,49,95,0.516,35,55,0.636,14,40,0.35,17,19,0.895,129,44,85,0.518,35,62,0.565,9,23,0.391,20,29,0.69,117
2531,2019/12/27,CLE,BOS,L 117-129,240,44,85,0.518,35,62,0.565,9,23,0.391,20,29,0.69,117,49,95,0.516,35,55,0.636,14,40,0.35,17,19,0.895,129
2532,2019/12/27,CHO,OKC,L 102-104 (OT),265,42,101,0.416,35,62,0.565,7,39,0.179,11,18,0.611,102,40,89,0.449,35,58,0.603,5,31,0.161,19,31,0.613,104
2533,2019/12/27,OKC,CHO,W 104-102 (OT),265,40,89,0.449,35,58,0.603,5,31,0.161,19,31,0.613,104,42,101,0.416,35,62,0.565,7,39,0.179,11,18,0.611,102
2534,2019/12/27,GSW,PHO,W 105-96,240,38,92,0.413,29,65,0.446,9,27,0.333,20,25,0.8,105,35,75,0.467,28,42,0.667,7,33,0.212,19,24,0.792,96
2535,2019/12/27,PHO,GSW,L 96-105,240,35,75,0.467,28,42,0.667,7,33,0.212,19,24,0.792,96,38,92,0.413,29,65,0.446,9,27,0.333,20,25,0.8,105
2536,2019/12/27,IND,MIA,L 112-113,240,44,90,0.489,30,59,0.508,14,31,0.452,10,12,0.833,112,40,89,0.449,24,51,0.471,16,38,0.421,17,19,0.895,113
2537,2019/12/27,MIA,IND,W 113-112,240,40,89,0.449,24,51,0.471,16,38,0.421,17,19,0.895,113,44,90,0.489,30,59,0.508,14,31,0.452,10,12,0.833,112
2538,2019/12/27,ORL,PHI,W 98-97,240,37,88,0.42,27,58,0.466,10,30,0.333,14,23,0.609,98,35,87,0.402,25,58,0.431,10,29,0.345,17,21,0.81,97
2539,2019/12/27,PHI,ORL,L 97-98,240,35,87,0.402,25,58,0.431,10,29,0.345,17,21,0.81,97,37,88,0.42,27,58,0.466,10,30,0.333,14,23,0.609,98
2540,2019/12/26,BRK,NYK,L 82-94,240,21,78,0.269,8,28,0.286,13,50,0.26,27,36,0.75,82,37,92,0.402,28,63,0.444,9,29,0.31,11,15,0.733,94
2541,2019/12/26,NYK,BRK,W 94-82,240,37,92,0.402,28,63,0.444,9,29,0.31,11,15,0.733,94,21,78,0.269,8,28,0.286,13,50,0.26,27,36,0.75,82
2542,2019/12/26,DAL,SAS,W 102-98,240,38,90,0.422,22,50,0.44,16,40,0.4,10,15,0.667,102,40,83,0.482,32,54,0.593,8,29,0.276,10,15,0.667,98
2543,2019/12/26,SAS,DAL,L 98-102,240,40,83,0.482,32,54,0.593,8,29,0.276,10,15,0.667,98,38,90,0.422,22,50,0.44,16,40,0.4,10,15,0.667,102
2544,2019/12/26,DET,WAS,W 132-102,240,46,86,0.535,27,38,0.711,19,48,0.396,21,26,0.808,132,38,92,0.413,31,68,0.456,7,24,0.292,19,27,0.704,102
2545,2019/12/26,WAS,DET,L 102-132,240,38,92,0.413,31,68,0.456,7,24,0.292,19,27,0.704,102,46,86,0.535,27,38,0.711,19,48,0.396,21,26,0.808,132
2546,2019/12/26,MEM,OKC,W 110-97,240,46,84,0.548,36,59,0.61,10,25,0.4,8,11,0.727,110,38,92,0.413,28,57,0.491,10,35,0.286,11,13,0.846,97
2547,2019/12/26,OKC,MEM,L 97-110,240,38,92,0.413,28,57,0.491,10,35,0.286,11,13,0.846,97,46,84,0.548,36,59,0.61,10,25,0.4,8,11,0.727,110
2548,2019/12/26,MIN,SAC,W 105-104 (2OT),290,36,104,0.346,26,58,0.448,10,46,0.217,23,29,0.793,105,37,107,0.346,28,68,0.412,9,39,0.231,21,25,0.84,104
2549,2019/12/26,SAC,MIN,L 104-105 (2OT),290,37,107,0.346,28,68,0.412,9,39,0.231,21,25,0.84,104,36,104,0.346,26,58,0.448,10,46,0.217,23,29,0.793,105
2550,2019/12/26,POR,UTA,L 115-121,240,43,89,0.483,28,55,0.509,15,34,0.441,14,19,0.737,115,46,81,0.568,32,45,0.711,14,36,0.389,15,22,0.682,121
2551,2019/12/26,UTA,POR,W 121-115,240,46,81,0.568,32,45,0.711,14,36,0.389,15,22,0.682,121,43,89,0.483,28,55,0.509,15,34,0.441,14,19,0.737,115
2552,2019/12/25,DEN,NOP,L 100-112,240,37,92,0.402,25,55,0.455,12,37,0.324,14,18,0.778,100,41,90,0.456,23,47,0.489,18,43,0.419,12,12,1,112
2553,2019/12/25,NOP,DEN,W 112-100,240,41,90,0.456,23,47,0.489,18,43,0.419,12,12,1,112,37,92,0.402,25,55,0.455,12,37,0.324,14,18,0.778,100
2554,2019/12/25,GSW,HOU,W 116-104,240,41,87,0.471,32,59,0.542,9,28,0.321,25,28,0.893,116,37,100,0.37,21,49,0.429,16,51,0.314,14,16,0.875,104
2555,2019/12/25,HOU,GSW,L 104-116,240,37,100,0.37,21,49,0.429,16,51,0.314,14,16,0.875,104,41,87,0.471,32,59,0.542,9,28,0.321,25,28,0.893,116
2556,2019/12/25,LAC,LAL,W 111-106,240,39,85,0.459,30,60,0.5,9,25,0.36,24,32,0.75,111,39,96,0.406,27,51,0.529,12,45,0.267,16,21,0.762,106
2557,2019/12/25,LAL,LAC,L 106-111,240,39,96,0.406,27,51,0.529,12,45,0.267,16,21,0.762,106,39,85,0.459,30,60,0.5,9,25,0.36,24,32,0.75,111
2558,2019/12/25,MIL,PHI,L 109-121,240,45,95,0.474,32,62,0.516,13,33,0.394,6,8,0.75,109,44,101,0.436,23,57,0.404,21,44,0.477,12,15,0.8,121
2559,2019/12/25,PHI,MIL,W 121-109,240,44,101,0.436,23,57,0.404,21,44,0.477,12,15,0.8,121,45,95,0.474,32,62,0.516,13,33,0.394,6,8,0.75,109
2560,2019/12/25,BOS,TOR,W 118-102,240,46,92,0.5,32,59,0.542,14,33,0.424,12,14,0.857,118,38,80,0.475,30,57,0.526,8,23,0.348,18,22,0.818,102
2561,2019/12/25,TOR,BOS,L 102-118,240,38,80,0.475,30,57,0.526,8,23,0.348,18,22,0.818,102,46,92,0.5,32,59,0.542,14,33,0.424,12,14,0.857,118
2562,2019/12/23,ATL,CLE,L 118-121,240,45,95,0.474,30,53,0.566,15,42,0.357,13,17,0.765,118,50,96,0.521,39,67,0.582,11,29,0.379,10,12,0.833,121
2563,2019/12/23,CLE,ATL,W 121-118,240,50,96,0.521,39,67,0.582,11,29,0.379,10,12,0.833,121,45,95,0.474,30,53,0.566,15,42,0.357,13,17,0.765,118
2564,2019/12/23,DET,PHI,L 109-125,240,43,84,0.512,33,54,0.611,10,30,0.333,13,18,0.722,109,52,95,0.547,40,65,0.615,12,30,0.4,9,11,0.818,125
2565,2019/12/23,PHI,DET,W 125-109,240,52,95,0.547,40,65,0.615,12,30,0.4,9,11,0.818,125,43,84,0.512,33,54,0.611,10,30,0.333,13,18,0.722,109
2566,2019/12/23,GSW,MIN,W 113-104,240,38,87,0.437,26,57,0.456,12,30,0.4,25,30,0.833,113,35,87,0.402,24,53,0.453,11,34,0.324,23,29,0.793,104
2567,2019/12/23,MIN,GSW,L 104-113,240,35,87,0.402,24,53,0.453,11,34,0.324,23,29,0.793,104,38,87,0.437,26,57,0.456,12,30,0.4,25,30,0.833,113
2568,2019/12/23,IND,TOR,W 120-115 (OT),265,45,95,0.474,27,53,0.509,18,42,0.429,12,20,0.6,120,43,94,0.457,32,54,0.593,11,40,0.275,18,24,0.75,115
2569,2019/12/23,TOR,IND,L 115-120 (OT),265,43,94,0.457,32,54,0.593,11,40,0.275,18,24,0.75,115,45,95,0.474,27,53,0.509,18,42,0.429,12,20,0.6,120
2570,2019/12/23,MEM,SAS,L 115-145,240,45,96,0.469,30,59,0.508,15,37,0.405,10,16,0.625,115,60,89,0.674,45,65,0.692,15,24,0.625,10,14,0.714,145
2571,2019/12/23,SAS,MEM,W 145-115,240,60,89,0.674,45,65,0.692,15,24,0.625,10,14,0.714,145,45,96,0.469,30,59,0.508,15,37,0.405,10,16,0.625,115
2572,2019/12/23,MIA,UTA,W 107-104,240,37,90,0.411,28,65,0.431,9,25,0.36,24,27,0.889,107,39,90,0.433,27,54,0.5,12,36,0.333,14,18,0.778,104
2573,2019/12/23,UTA,MIA,L 104-107,240,39,90,0.433,27,54,0.5,12,36,0.333,14,18,0.778,104,37,90,0.411,28,65,0.431,9,25,0.36,24,27,0.889,107
2574,2019/12/23,NYK,WAS,L 115-121,240,44,93,0.473,29,57,0.509,15,36,0.417,12,15,0.8,115,47,100,0.47,37,70,0.529,10,30,0.333,17,30,0.567,121
2575,2019/12/23,WAS,NYK,W 121-115,240,47,100,0.47,37,70,0.529,10,30,0.333,17,30,0.567,121,44,93,0.473,29,57,0.509,15,36,0.417,12,15,0.8,115
2576,2019/12/23,CHI,ORL,L 95-103,240,35,88,0.398,22,51,0.431,13,37,0.351,12,15,0.8,95,39,81,0.481,29,55,0.527,10,26,0.385,15,23,0.652,103
2577,2019/12/23,ORL,CHI,W 103-95,240,39,81,0.481,29,55,0.527,10,26,0.385,15,23,0.652,103,35,88,0.398,22,51,0.431,13,37,0.351,12,15,0.8,95
2578,2019/12/23,DEN,PHO,W 113-111,240,43,78,0.551,28,50,0.56,15,28,0.536,12,15,0.8,113,42,87,0.483,29,50,0.58,13,37,0.351,14,18,0.778,111
2579,2019/12/23,PHO,DEN,L 111-113,240,42,87,0.483,29,50,0.58,13,37,0.351,14,18,0.778,111,43,78,0.551,28,50,0.56,15,28,0.536,12,15,0.8,113
2580,2019/12/23,NOP,POR,W 102-94,240,38,93,0.409,23,58,0.397,15,35,0.429,11,16,0.688,102,37,91,0.407,33,62,0.532,4,29,0.138,16,18,0.889,94
2581,2019/12/23,POR,NOP,L 94-102,240,37,91,0.407,33,62,0.532,4,29,0.138,16,18,0.889,94,38,93,0.409,23,58,0.397,15,35,0.429,11,16,0.688,102
2582,2019/12/23,HOU,SAC,W 113-104,240,39,87,0.448,24,48,0.5,15,39,0.385,20,23,0.87,113,41,87,0.471,34,57,0.596,7,30,0.233,15,23,0.652,104
2583,2019/12/23,SAC,HOU,L 104-113,240,41,87,0.471,34,57,0.596,7,30,0.233,15,23,0.652,104,39,87,0.448,24,48,0.5,15,39,0.385,20,23,0.87,113
2584,2019/12/22,BOS,CHO,W 119-93,240,46,88,0.523,32,56,0.571,14,32,0.438,13,16,0.813,119,33,82,0.402,23,48,0.479,10,34,0.294,17,23,0.739,93
2585,2019/12/22,CHO,BOS,L 93-119,240,33,82,0.402,23,48,0.479,10,34,0.294,17,23,0.739,93,46,88,0.523,32,56,0.571,14,32,0.438,13,16,0.813,119
2586,2019/12/22,DEN,LAL,W 128-104,240,45,92,0.489,34,60,0.567,11,32,0.344,27,30,0.9,128,39,83,0.47,29,54,0.537,10,29,0.345,16,22,0.727,104
2587,2019/12/22,LAL,DEN,L 104-128,240,39,83,0.47,29,54,0.537,10,29,0.345,16,22,0.727,104,45,92,0.489,34,60,0.567,11,32,0.344,27,30,0.9,128
2588,2019/12/22,IND,MIL,L 89-117,240,37,100,0.37,25,60,0.417,12,40,0.3,3,5,0.6,89,44,104,0.423,29,60,0.483,15,44,0.341,14,17,0.824,117
2589,2019/12/22,MIL,IND,W 117-89,240,44,104,0.423,29,60,0.483,15,44,0.341,14,17,0.824,117,37,100,0.37,25,60,0.417,12,40,0.3,3,5,0.6,89
2590,2019/12/22,LAC,OKC,L 112-118,240,40,86,0.465,29,59,0.492,11,27,0.407,21,24,0.875,112,46,97,0.474,37,70,0.529,9,27,0.333,17,20,0.85,118
2591,2019/12/22,OKC,LAC,W 118-112,240,46,97,0.474,37,70,0.529,9,27,0.333,17,20,0.85,118,40,86,0.465,29,59,0.492,11,27,0.407,21,24,0.875,112
2592,2019/12/22,DAL,TOR,L 107-110,240,35,90,0.389,20,44,0.455,15,46,0.326,22,27,0.815,107,37,94,0.394,27,60,0.45,10,34,0.294,26,31,0.839,110
2593,2019/12/22,TOR,DAL,W 110-107,240,37,94,0.394,27,60,0.45,10,34,0.294,26,31,0.839,110,35,90,0.389,20,44,0.455,15,46,0.326,22,27,0.815,107
2594,2019/12/21,ATL,BRK,L 112-122,240,39,105,0.371,28,57,0.491,11,48,0.229,23,27,0.852,112,46,100,0.46,35,70,0.5,11,30,0.367,19,28,0.679,122
2595,2019/12/21,BRK,ATL,W 122-112,240,46,100,0.46,35,70,0.5,11,30,0.367,19,28,0.679,122,39,105,0.371,28,57,0.491,11,48,0.229,23,27,0.852,112
2596,2019/12/21,CHO,UTA,L 107-114,240,39,85,0.459,27,56,0.482,12,29,0.414,17,22,0.773,107,39,75,0.52,22,41,0.537,17,34,0.5,19,20,0.95,114
2597,2019/12/21,UTA,CHO,W 114-107,240,39,75,0.52,22,41,0.537,17,34,0.5,19,20,0.95,114,39,85,0.459,27,56,0.482,12,29,0.414,17,22,0.773,107
2598,2019/12/21,CHI,DET,W 119-107,240,40,77,0.519,22,42,0.524,18,35,0.514,21,25,0.84,119,40,87,0.46,24,52,0.462,16,35,0.457,11,12,0.917,107
2599,2019/12/21,DET,CHI,L 107-119,240,40,87,0.46,24,52,0.462,16,35,0.457,11,12,0.917,107,40,77,0.519,22,42,0.524,18,35,0.514,21,25,0.84,119
